Rr, Gs^Fp, Gg, Gg, Gg, Gg, Gg, Gg, Gg, Gg, Gg, Gg, Gs^Fp, Re, Re, Gs^Fp, Gg, Gg, Gg, Gg, Gs^Fp, Gg, Hh, Rr, Mm, Mm, Mm, Mm, Hh, Mm, Hh
Gs^Fp, Rr, Rr, Gg, Gg, Gg, Gg, Gg, Gg, Gg, Gg, Gg, Hh, Mm^Xm, Re, Gg, Gg, Gg, Re, Gg, Gg, Mm^Xm, Rr, Rr, Gs^Fp, Mm, Hh, Gs^Fp, Hh, Mm, Hh
Hh, Gg, Gg, Rr, Gg, Gg, Gg, Gg, Chr, Gg, Gg, Gg, Re, Re, Gg, Gg, Gg, Re, Mm, Re, Re, Gg^Ve, Rr, Hh, Gg, Gg, Gg, Hh^Vhh, Gs^Fp, Mm, Mm
Mm, Hh^Vhh, Gg, Rr, Rr, 1 Khr, Chr, Chr, Gg, Gg, Gs^Fp, Gs^Fp, Re, Gg^Vh, Gg, Gg, Re, Re, Gs^Fp, Hh, Rd, Rr, Hh, Rr, Rr, Gg, Gg, Gg, Gg, Hh, Gs^Fp
Mm, Gs^Fp, Gs^Fp, Gg, Rr, Chr, Gg, Chr, Gg, Gg, Hh, Mm, Re, Rd, Rd, Rr, Re, Gs^Fp, Hh, Tb, Rr, Rd, Gs^Fp, Mm, Rr, Gg, Gg, Gg, Gg, Gs^Fp, Mm
Hh, Mm, Hh, Gg, Gg, Rr, Rr, Gg, Gg, Gg, Re, Re, Rr, Re, Hh, Rd, Re, Rp, Gs^Ft, Rr, Rd, Ss^Vhs, Wwf, Rr, Ce, Ce, Ke, Ce, Gg, Gg, Gg
Gs^Fp, Ss, Mm, Gs^Fp, Hh, Gg, Rr, Gg, Gg, Gg, Re, Gg^Ve, Rd, Rr, Gs^Fp, Re, Rd, Wwf, Rp, Wwf, Wwf, Wwf, Re, Wwf, Wwf, Wwf, Gg, Gg, Gg, Gg, Gg
Gg, Gs^Fp, Gg, Hh, Gs^Fp, Gg, Gg, Rr, Rr, Re, Gs^Fp, Gg, Hh, Re, Mm^Xm, Mm, Rr, Ww^Bw/, Wwf, Gs, Rr, Re, Gs^Ft, Chw, Ww, Ww, Ww, Gg, Wwf, Ww, Ww
Gg, Gg, Ds, Gg, Gg, Gg, Gg, Gg, Gg, Rr, Rp, Rp, Re, Re, Re, Rr, Gs^Ft, Ss, Ss, Gg^Vc, Re, Re, Mm, Wwf, Gs^Fp, Ss, Ss, Wwf, Gg^Ve, Ww, Ww
Gg, Ds, Ww, Ww, Wwf, Ss^Vhs, Hh, Gg, Gs^Fp, Rr, Ql, Re, Mm, Gs^Fp, Cv, Re, Hh, Ss, Tb, Rd, Rr, Hh, Wwf, Wwf, Mm, Hh, Wwf, Wwf, Ww, Ww, Gg
Gg, Ww, Ww, Wo, Wwf, Gs^Fp, Mm, Hh, Wwf, Rr, Rr, Rd, Tb, Tb, Hh, Re, Cv, Tb, Mm, Rd, Ql, Rr, Gs^Fp, Hh, Hh, Gs^Fp, Wwf, Wo, Ww, Ww, Gg
Ww, Ww, Gg^Ve, Wwf, Ss, Hh, Gs^Fp, Wwf, Mm, Hh, Re, Rd, Ss, Ss, Gs^Ft, Re, Re, Gs^Fp, Re, Re, Rp, Rr, Gg, Gg, Gg, Ss^Vhs, Gg, Ww, Ds, Ds, Gg
Ww, Ww, Wwf, Wwf, Ww, Ss, Ww, Wwf, Gs^Ft, Re, Rr, Gg^Vc, Wwf, Ss, Rr, Rr, Mm^Xm, Re, Hh, Rp, Gs^Fp, Rr, Rr, Gg, Gg, Gg, Gs^Fp, Gg, Gg, Gg, Gg
Gg, Ww, Gg, Gg, Gg, Ww, Wwf, Chw, Re, Re, Wwf, Gs, Rp, Ww^Bw/, Rd, Mm, Gs^Fp, Re, Rd, Gg, Re, Re, Gg, Rr, Rr, Gg, Hh, Hh, Mm, Gs^Fp, Gs^Fp
Gg, Gg, Gg, Gg, Ke, Wwf, Ce, Wwf, Wwf, Wwf, Rd, Wwf, Gs^Ft, Wwf, Re, Re, Hh, Rr, Rr, Gg^Ve, Re, Gg, Gg, Gg, Rr, Gg, Gg, Gs^Fp, Hh, Ss, Hh
Gg, Gg, Gg, Ce, Gg, Ce, Rr, Rr, Gs^Fp, Ss^Vhs, Rr, Rr, Hh, Rp, Re, Rd, Rd, Re, Re, Re, Hh, Gg, Gg, Gg, Gg, Rr, Rr, Gg, Gs^Fp, Mm, Mm
Mm, Gs^Fp, Gg, Gg, Gg, Gg, Rr, Mm, Hh, Rd, Rd, Tb, Gs^Fp, Gs^Fp, Re, Rr, Gg, Rd, Re, Mm, Gs^Fp, Gg, Gg, Chr, Chr, Chr, Rr, Gg, Gg, Gs^Fp, Mm
Gs^Fp, Hh, Gs^Fp, Gg, Gg, Gg, Gg, Rr, Rr, Rr, Re, Hh, Mm, Re, Gg, Gg, Gg, Gg^Vh, Re, Gs^Fp, Hh, Gg, Chr, Chr, Gg, 2 Khr, Gg, Rr, Gg, Hh^Vhh, Hh
Mm, Mm, Hh, Hh^Vhh, Hh, Gs^Fp, Gs^Fp, Hh, Rr, Gg^Ve, Gg, Re, Re, Re, Gg, Gg, Gg, Re, Hh, Gg, Gg, Gg, Gg, Gg, Gg, Gg, Gg, Rr, Rr, Gg, Gs^Fp
Mm, Mm, Mm, Gs^Fp, Mm, Mm, Mm, Rr, Hh, Gs^Fp, Gg, Gg, Gg, Gg, Gg, Gs^Fp, Mm, Re, Gs^Fp, Hh, Gg, Gg, Gg, Gg, Gg, Gg, Gg, Gg, Gs^Fp, Rr, Rr
