Xv, Xv, Xv, Xv, Xv, Xv, Xv, Xv, Xv, Xv, Xv, Xv, Xv, Xv, Xv, Xv, Xv, Xv, Xv, Xv, Xv, Xv, Xv, Xv, Xv, Xv, Xv, Xv, Xv, Xv, Xv
Xv, Xv, Xv, Xv, Xv, Xv, Xv, Xv, Xv, Xv, Qxua^Xo, Xv, Qxua^Xo, Xv, Qxua^Xo, Xv, Qxua^Xo, Xv, Qxua^Xo, Xv, Xv, Xv, Xv, Xv, Xv, Xv, Xv, Xv, Xv, Xv, Xv
Xv, Xv, Xv, Xv, Xv, Xv, Xv, Xv, Qxua^Xo, Qxua^Xo, Wwf, Qxua^Xo, Hh, Qxua^Xo, Mm, Qxua^Xo, Gs^Fp, Qxua^Xo, Rp, Qxua^Xo, Qxua^Xo, Xv, Xv, Xv, Xv, Xv, Xv, Xv, Xv, Xv, Xv
Xv, Xv, Xv, Xv, Xv, Xv, Qxua^Xo, Qxua^Xo, Wwf, Wwf, Ww^Vm, Wwf, Khr, 2 Khr, Chr, Hh, Hh, Rp, Hh^Vhh, Hh, Mm, Qxua^Xo, Xv, Xv, Xv, Xv, Xv, Xv, Xv, Xv, Xv
Xv, Xv, Xv, Xv, Xv, Xv, Qxua^Xo, Wwf, Hh, Gs^Fp, Hh, Wwf, Wwf, Rr, Rr, Chr, Chr, Rp, Rr, Gs^Fp, Rr, Qxua^Xo, Qxua^Xo, Xv, Xv, Xv, Xv, Xv, Xv, Xv, Xv
Xv, Xv, Xv, Xv, Qxua^Xo, Qxua^Xo, Wwf, Wwf, Gs, Gs^Fp, Gs^Efm, Mm, Re, Wwf, Wwf, Wwf, Rp, Rp, Wwf, Rr, Hh, Rr, Rr, Qxua^Xo, Xv, Xv, Xv, Xv, Xv, Xv, Xv
Xv, Xv, Xv, Xv, Qxua^Xo, Wwf, Rp, Chs, Rp, Gs^Vc, Gs, Re, Rd, Rd, Re, Re, Re, Rr, Wwf, Rr, Rr, Gs^Fp, Gs, Qxua^Xo, Qxua^Xo, Xv, Xv, Xv, Xv, Xv, Xv
Xv, Xv, Xv, Qxua^Xo, Wwf, Wwf, Sm^Vhs, Rp, Re, Rp, Rr, Gs^Fp, Rd, Uu^Vud, Xu, Xu^Efs, Rd, Rr, Sm^Vhs, Wwf, Rr, Gs^Ve, Gs^Efm, Hh, Rp, Qxua^Xo, Qxua^Xo, Xv, Xv, Xv, Xv
Xv, Xv, Qxua^Xo, Qxua^Xo, Wwf, Rd, Rd, Re, Uh, Rb^Tf, Rd, Rr, Rr, Rr, Uh, Rd, Xu, Hh, Gs^Fp, Rr, Rr, Rp, Rp, Rp, Mm, Rp, Rp, Qxua^Xo, Xv, Xv, Xv
Xv, Xv, Qxua^Xo, Mm, Wwf, Re, Re, Re, Re, Gs^Fp, Gg, Mm, Xu^Efs, Xu^Efs, Ww, Rb^Tf, Xu^Efs, Xu^Efs, Uh, Wwf, Wwf, Rp, Gs^Fp, Ww, Ww, Hh, Wwf, Qxua^Xo, Qxua^Xo, Xv, Xv
Xv, Xv, Qxua^Xo, Wwf, Rr, Gs^Fp, Mm^Xm, Rr, Rr, Rr, Rr, Rr, Xu, Gs^Fp, Gs^Efm, Xu, Wwf, Xu, Wwf, Wwf, Gs, Rd, Mm^Xm, Ww, Mm^Xm, Wwf, Rr, Wwf, Qxua^Xo, Xv, Xv
Xv, Xv, Qxua^Xo, Wwf, Rr, Rr, Mm^Xm, Mm^Xm, Mm^Xm, Rb^Tf, Gs, Wwf, Wwf, Wwf, Wwf, Uh, Gs^Efm, Wwf, Xu^Efs, Wwf, Rr, Tb^Tf, Rr, Mm^Xm, Mm^Xm, Rr, Rr, Wwf, Qxua^Xo, Xv, Xv
Xv, Xv, Qxua^Xo, Wwf, Wwf, Wwf, Ww, Ww, Gs^Fp, Rd, Wwf, Wwf, Uh, Xu, Xu^Efs, Xu, Ww, Gs^Fp, Xu^Efs, Rr, Rd, Rr, Re, Rr, Re, Gs^Fp, Wwf, Wwf, Qxua^Xo, Xv, Xv
Xv, Xv, Xv, Qxua^Xo, Rp, Hh, Mm, Ww, Rp, Rp, Rr, Wwf, Gs^Fp, Xu^Efs, Xu, Rb^Tf, Uh, Xu, Rr, Mm, Rd, Gs^Fp, Uh, Re, Rd, Re, Wwf, Mm, Qxua^Xo, Xv, Xv
Xv, Xv, Xv, Qxua^Xo, Qxua^Xo, Rp, Rp, Rp, Gs^Efm, Rp, Rr, Rr, Sm^Vhs, Hh, Rd, Rd, Xu^Efs, Rr, Rd, Rr, Rr, Rb^Tf, Re, Re, Sm^Vhs, Rd, Wwf, Qxua^Xo, Xv, Xv, Xv
Xv, Xv, Xv, Xv, Xv, Qxua^Xo, Qxua^Xo, Hh, Gs, Gs^Ve, Rr, Wwf, Wwf, Rr, Re, Xu, Re, Uu^Vud, Rd, Gs^Fp, Gs, Rp, Rp, Rp, Rp, Wwf, Qxua^Xo, Qxua^Xo, Xv, Xv, Xv
Xv, Xv, Xv, Xv, Xv, Xv, Xv, Qxua^Xo, Rr, Gs^Fp, Hh, Rr, Wwf, Rr, Rp, Re, Wwf, Rd, Re, Re, Gs^Efm, Gs^Vc, Gs, Chs, Wwf, Wwf, Qxua^Xo, Xv, Xv, Xv, Xv
Xv, Xv, Xv, Xv, Xv, Xv, Xv, Qxua^Xo, Qxua^Xo, Rr, Rr, Rr, Rr, Rp, Chr, Wwf, Rr, Wwf, Wwf, Mm, Hh, Gs^Fp, Hh, Wwf, Qxua^Xo, Qxua^Xo, Xv, Xv, Xv, Xv, Xv
Xv, Xv, Xv, Xv, Xv, Xv, Xv, Xv, Xv, Qxua^Xo, Mm, Gs^Fp, Hh^Vhh, Rp, Hh, Chr, Chr, Rr, Khr, Wwf, Ww^Vm, Gs^Fp, Wwf, Wwf, Qxua^Xo, Xv, Xv, Xv, Xv, Xv, Xv
Xv, Xv, Xv, Xv, Xv, Xv, Xv, Xv, Xv, Qxua^Xo, Qxua^Xo, Hh, Rp, Rp, Gs^Fp, Hh, Mm, 1 Khr, Hh, Wwf, Wwf, Wwf, Qxua^Xo, Qxua^Xo, Xv, Xv, Xv, Xv, Xv, Xv, Xv
Xv, Xv, Xv, Xv, Xv, Xv, Xv, Xv, Xv, Xv, Xv, Qxua^Xo, Qxua^Xo, Qxua^Xo, Qxua^Xo, Qxua^Xo, Qxua^Xo, Qxua^Xo, Qxua^Xo, Qxua^Xo, Qxua^Xo, Qxua^Xo, Xv, Xv, Xv, Xv, Xv, Xv, Xv, Xv, Xv
Xv, Xv, Xv, Xv, Xv, Xv, Xv, Xv, Xv, Xv, Xv, Xv, Xv, Xv, Xv, Xv, Xv, Xv, Xv, Xv, Xv, Xv, Xv, Xv, Xv, Xv, Xv, Xv, Xv, Xv, Xv
Xv, Xv, Xv, Xv, Xv, Xv, Xv, Xv, Xv, Xv, Xv, Xv, Xv, Xv, Xv, Xv, Xv, Xv, Xv, Xv, Xv, Xv, Xv, Xv, Xv, Xv, Xv, Xv, Xv, Xv, Xv
