border_size=1
usage=map

Xv, Xv, Xv, Xv, Xv, Xv, Xv, Xv, Xv, Xv, Xv, Xv, Xv, Xv, Xv, Xv, Xv, Xv, Xv, Xv, Xv, Xv, Xv, Xv, Xv, Xv, Xv, Xv, Xv, Xv, Xv, Xv, Xv, Xv, Xv
Xv, Xv, Xv, Xv, Xv, Xv, Wo, Wo, Wo, Wo, Wo, Ai, Wo, Wo, Wo, Wo, Wo, Xv, Xv, Xv, Xv, Xv, Xv, Xv, Xv, Xv, Xv, Xv, Xv, Xv, Xv, Xv, Xv, Xv, Xv
Xv, Xv, Xv, Xv, Wo, Wo, Ww, Ww, Ww, Ww, Ww, Wo, Ww, Ww, Ww, Ww, Ww, Wo, Wo, Xv, Xv, Xv, Xv, Xv, Xv, Xv, Xv, Xv, Xv, Xv, Xv, Xv, Xv, Xv, Xv
Xv, Xv, Wo, Wo, Ww, Ww, Wwf, Wwf, Wwf, Wwf, Wwf, Ww, Ai^Vu, Ai, Ai, Wwf, Wwf, Ww, Ww, Wo, Wo, Xv, Xv, Xv, Xv, Xv, Xv, Xv, Xv, Xv, Xv, Xv, Xv, Xv, Xv
Xv, Xv, Wo, Ww, Wwf, Wwf, Wo, Cha, Ai, Ai^Fetd, Ai^Fp, Wwf, Ai, Rb, Rb^Uf, Ai^Fp, Rb^Dr, Wwf, Wo, Ww, Rb^Fp, Ai^Fp, Ai, Xv, Xv, Xv, Xv, Xv, Xv, Xv, Xv, Xv, Xv, Xv, Xv
Xv, Xv, Wo, Ww, Wwf, Rb^Uf, 1 Kha, Cha, Rb^Es, Rb^Fp, Rb^Edp, Ai, Wwf, Wwf, Wwf, Rb^Em, Wwf, Wwf, Wwf, Wwf, Rb^Edp, Rb, Rb, Ai, Rb^Dr, Xv, Xv, Xv, Xv, Xv, Xv, Xv, Xv, Xv, Xv
Xv, Xv, Wo, Ww, Wwf, Rb^Em, Cha, Rr, Wwf, Rb, Wwf, Wwf, Rb^Es, Rb^Dr, Ai^Fp, Wwf, Ai, Ai^Uf, Rb^Es, Rb^Dr, Rr, Wwf, Rr, Ai, Rb^Es, Hhd, Md, Xv, Xv, Xv, Xv, Xv, Xv, Xv, Xv
Xv, Xv, Wo, Ww, Ww, Ai, Wwf, Rr, Rr, Rr, Wo^Bw\, Rr, Rb, Ai, Wwf, Wwf, Rb^Fp, Ai^Em, Rb, Rr, Rb^Fp, Rr, Rb^Edp, Rr, Rr, Rb^Edp, Rb^Fp, Ai, Ai, Xv, Xv, Xv, Xv, Xv, Xv
Xv, Xv, Ai, Wo, Ww, Wwf, Wwf, Cha, Ai, Wo, Wo, Rr, Rr, Ai^Vu, Wwf, Rb^Edp, Rb, Sm, Rb, Rr, Md, Hhd, Ai^Em, Ai^Uf, Ai, Rr, Rr, Rb^Fp, Rb, Rr, Rb^Es, Xv, Xv, Xv, Xv
Xv, Xv, Wo, Wo, Ww, Ww, Wwf, Ai, Rb^Em, Rb^Fp, Wo, Ai^Uf, Ai, Rr, Rr, Wwf, Wwf, Rb^Em, Rr, Rr, Wwf, Wwf, Rb^Edp, Rb, Rb^Edp, Ai^Vu, Rr, Rr, Rr, Rr, Rb^Fp, Ai, Sm, Xv, Xv
Xv, Xv, Wo, Ww, Wwf, Wwf, Wwf, Ai, Wwf, Rb^Uf, Wwf, Rb^Em, Ai, Md^Xm, Md, Rr, Kha, Rb^Uf, Rr, Rb^Vc, Rb, Rb^Fp, Rb^Uf, Rb^Fp, Wwf, Wwf, Rr, Wwf, Ai^Dr, Rr, Rr, Ai, Ai, Xv, Xv
Xv, Xv, Wo, Ww, Rb^Dr, Rb^Es, Rb, Rb^Vht, Wwf, Ww^Ewl, Rb, Rb^Es, Rb, Ai^Fp, Rr, Rr, Cha, Wog, Kha, Rr, Wwf, Rb^Em, Wwf, Ai^Dr, Wwf, Rr, Rb, Wwf, Wwf, Ai, Wwf, Rr, Md^Xm, Xv, Xv
Xv, Xv, Wo, Wwf, Ms^Xm, Ai^Em, Ai^Uf, Ww^Ewl, Wwf, Wo, Ww^Ewl, Ai^Fetd, Ai, Rb, Rr, Rb^Em, Rb^Uf, Cha, Ai^Em, Rr, Rr, Wwf, Ai, Ai, Ai^Fp, Rr, Rb^Vc, Rb^Edp, Ai^Fp, Ai, Rr, Rr, Md, Xv, Xv
Xv, Xv, Wwf, Wwf, Wwf, Wwf, Wwf, Wo, Wwf, Wwf, Wwf, Wo, Kha, Wwf, Rr, Rb, Sm^Vht, Sm, Ww^Ewl, Ai^Uf, Rb^Em, Rr, Cha, Kha, Rr, Rr, Rr, Rb^Es, Mm, Rr, Rb^Dr, Rb^Fp, Sm, Xv, Xv
Xv, Xv, Wwf, Wo, Wwf, Ww^Ewl, Wwf, Ai, Wwf, Ww^Ewl, Rr^Vc, Ai, Cha, Cha, Rr, Wwf, Wo, Wo, Wo, Ai^Fp, Ai, Rr, Rr, Cha, Rr, Rb^Dr, Rr, Ai^Fp, Ai^Uf, Rr, Rr, Rr, Rr, Xv, Xv
Xv, Xv, Rb, Wwf, Ai, Wwf, Wo, Wwf, Wo, Ai^Uf, Ai^Fp, Rr, Rr, Rr, Rb^Es, Rb, Wwf^Es, Wwr, Wwf, Wwf, Ai^Fp, Rb^Dr, Wo, Rr, Wwf, Wwf, Wwf, Rr, Rr, Rr, Hhd, Md, Hhd, Xv, Xv
Xv, Xv, Rb^Es, Ww^Ewl, Ai, Ww^Ewl, Wwf, Wwf, Wo, Wwf, Ww^Ewl, Rb^Edp, Ai^Fp, Ai^Dr, Wo, Wwf, Sm^Uf, Rr^Fp, Hhd^Em, Wo, Wwf, Wwf, Ww^Ewl, Ww^Ewl, Wwf, Ww^Ewl, Wwf, Ai, Ai, Rb, Rb^Em, Ai^Uf, Ai^Fp, Xv, Xv
Xv, Xv, Ai^Fp, Rb, Rb^Em, Wwf, Ai, Wo, Wwf, Wwf, Wwf, Wwf, Ww^Ewl, Wwf, Wwf, Wo, Hhd^Em, Sm, Sm^Uf, Wo, Wo, Wwf, Ai^Fp, Wwf, Ww^Ewl, Wwf, Wo, Wo, Wwf, Wwf, Ai, Rb, Rb^Es, Xv, Xv
Xv, Xv, Hhd, Ai^Uf, Hhd, Rb, Rr, Ai, Wwf, Ww^Ewl, Wwf, Ww^Ewl, Wo, Wwf, Ai^Fp, Wo, Wwf, Rr^Fp, Wwf^Es, Wwf, Rb^Es, Ai^Dr, Rr, Rb^Edp, Ai^Fp, Wwf, Wo, Wwf, Wo, Ww^Ewl, Ai, Ww^Ewl, Rb, Xv, Xv
Xv, Xv, Rr, Md, Rr, Rr, Ai^Uf, Rr, Rr, Wwf, Rr, Rr, Rr, Rb^Dr, Ai, Wwf, Wo, Wwr, Wo, Rb, Rr, Rr, Cha, Rr, Rr^Vc, Ai^Uf, Wwf, Wwf, Wwf, Wwf, Wwf, Wwf, Wwf, Xv, Xv
Xv, Xv, Sm, Rr, Rb^Dr, Rr, Mm, Ai^Fp, Rr, Rb^Dr, Rr, Cha, Cha, Rr, Rb^Em, Ai^Fp, Ww^Ewl, Wo, Sm^Vht, Wwf, Rr, Cha, Kha, Ai, Wwf, Ww^Ewl, Wwf, Ai, Wwf, Ww^Ewl, Wwf, Wo, Wwf, Xv, Xv
Xv, Xv, Md, Rb^Fp, Rr, Rr, Ai^Fp, Rb^Es, Rb^Vc, Rr, Ai^Fp, Kha, Ai, Rr, Rr, Ai^Uf, Ai^Em, Sm, Rb^Uf, Rb, Rr, Wwf, Ai, Wo, Ww^Ewl, Wwf, Wwf, Wo, Ai^Uf, Wwf, Ms^Xm, Wwf, Wo, Xv, Xv
Xv, Xv, Md^Xm, Rr, Wwf, Ai, Wwf, Rb^Edp, Rb, Rr, Wwf, Ai, Wwf, Wwf, Wwf, Rr, Kha, Cha, Cha, Rb^Em, Rr, Rb, Rb, Ai^Fetd, Rb, Wo, Wwf, Ww^Ewl, Rb, Ai^Em, Rb^Dr, Wwf, Wo, Xv, Xv
Xv, Xv, Ai, Rr, Rr, Ai, Ai^Dr, Wwf, Rr, Rr, Wwf, Ai^Dr, Rb^Uf, Rb^Em, Rb, Rr, Rr, Wog, Kha, Rr, Md, Ai^Fp, Ai, Rb^Es, Wwf, Ww^Ewl, Wwf, Rb^Vht, Wwf, Rb^Es, Wwf, Ww, Wo, Xv, Xv
Xv, Xv, Sm, Ai, Rb^Fp, Rr, Rr, Wwf, Rr, Wwf, Rb^Edp, Rb^Fp, Rb^Edp, Rb^Fp, Wwf, Rb^Vc, Rr, Rb^Uf, Wwf, Rr, Rr, Md^Xm, Ai, Rb^Em, Wo, Rb^Uf, Rb^Em, Ai, Wwf, Wwf, Ww, Ww, Wo, Xv, Xv
Xv, Xv, Xv, Ai, Rb^Es, Rr, Rb, Rr, Rr, Ai^Vu, Ai, Rb, Ai^Em, Wwf, Md, Rr, Rb, Rb^Em, Rb, Wwf, Wwf, Rr, Rr, Ai^Uf, Wo, Rb^Fp, Ai, Ai, Wwf, Ww, Ww, Wo, Ai, Xv, Xv
Xv, Xv, Xv, Xv, Xv, Rr, Ai, Rb^Fp, Rb^Fp, Rr, Rr, Ai^Uf, Rb^Edp, Hhd, Rb^Fp, Rr, Rb, Sm, Rb^Fp, Rb^Edp, Wwf, Ai^Vu, Rb, Rr, Wo^Bw\, Wo, Rr, Cha, Wwf, Wwf, Ww, Wo, Wo, Xv, Xv
Xv, Xv, Xv, Xv, Xv, Xv, Xv, Ai, Md, Rb^Edp, Rb^Es, Rr, Rr, Rr, Rr, Rr, Rb^Es, Ai^Em, Ai, Wwf, Ai^Fp, Ai, Rb^Es, Rr, Wwf, Rr, Wwf, Rr, Cha, Ai, Wwf, Ww, Wo, Xv, Xv
Xv, Xv, Xv, Xv, Xv, Xv, Xv, Xv, Xv, Hhd, Rb^Dr, Ai, Rb, Wwf, Rb^Edp, Rb^Dr, Wwf, Ai^Uf, Wwf, Wwf, Wwf, Rb^Dr, Wwf, Wwf, Rb^Edp, Rb, Rb^Es, Rr, 2 Kha, Rb^Em, Wwf, Ww, Wo, Xv, Xv
Xv, Xv, Xv, Xv, Xv, Xv, Xv, Xv, Xv, Xv, Xv, Ai, Ai, Rb, Rb^Fp, Wwf, Wo, Wwf, Rb^Dr, Rb^Em, Rb^Uf, Wwf, Ai, Ai, Ai^Fp, Rb^Fp, Ai, Cha, Wo, Rb^Uf, Wwf, Ww, Wo, Xv, Xv
Xv, Xv, Xv, Xv, Xv, Xv, Xv, Xv, Xv, Xv, Xv, Xv, Xv, Ai^Fp, Wo, Ww, Ww, Wwf, Wwf, Ai^Fp, Ai, Rb, Ai^Vu, Wwf, Wwf, Ai^Fetd, Wwf, Cha, Wwf, Wwf, Ww, Ww, Wo, Xv, Xv
Xv, Xv, Xv, Xv, Xv, Xv, Xv, Xv, Xv, Xv, Xv, Xv, Xv, Xv, Xv, Wo, Wo, Ww, Ww, Wwf, Ww, Ai, Ww, Ww, Ww, Wwf, Ww, Wwf, Ww, Ww, Wo, Wo, Xv, Xv, Xv
Xv, Xv, Xv, Xv, Xv, Xv, Xv, Xv, Xv, Xv, Xv, Xv, Xv, Xv, Xv, Xv, Xv, Wo, Wo, Ww, Wo, Ww, Wo, Wo, Wo, Ww, Wo, Ww, Wo, Wo, Xv, Xv, Xv, Xv, Xv
Xv, Xv, Xv, Xv, Xv, Xv, Xv, Xv, Xv, Xv, Xv, Xv, Xv, Xv, Xv, Xv, Xv, Xv, Xv, Wo, Xv, Wo, Xv, Ai, Xv, Wo, Xv, Wo, Xv, Xv, Xv, Xv, Xv, Xv, Xv
Xv, Xv, Xv, Xv, Xv, Xv, Xv, Xv, Xv, Xv, Xv, Xv, Xv, Xv, Xv, Xv, Xv, Xv, Xv, Xv, Xv, Xv, Xv, Xv, Xv, Xv, Xv, Xv, Xv, Xv, Xv, Xv, Xv, Xv, Xv
