Xv, Xv, Xv, Xv, Xv, Xv, Xv, Xv, Xv, Xv, Xv, Xv, Xv, Xv, Xv, Xv, Xv, Xv, Xv, Xv, Xv, Xv, Xv, Xv, Xv, Xv, Xv
Xv, Xv, Xv, Xv, Xv, Xv, Xv, Xv, Xv, Xv, Xv, Xv, Xv, Xv, Xv, Xv, Xv, Xv, Xv, Xv, Xv, Xv, Xv, Xv, Xv, Xv, Xv
Xv, Xv, Xv, Xv, Xv, Xv, Xv, Xv, Xv, Xv, Xv, Xv, Re, Re, Gs^Fp, Mm, Rr, Hh, Gs^Fp, Xv, Xv, Xv, Xv, Xv, Xv, Xv, Xv
Xv, Xv, Xv, Xv, Xv, Xv, Xv, Xv, Xv, Xv, Ce, Rd, Rd, Rd, Rd, Rd, Rr, Gg^Vc, Rr, Rr, Rr, Xv, Xv, Xv, Xv, Xv, Xv
Xv, Xv, Xv, Xv, Gs^Fp, Xv, Hh, Xv, Hh, Ss, 2 Ke, Ce, Hh, Uu^Vud, Rd, Rr, Rd, Rr, Gs^Fp, Hh, Rd, Xv, Xv, Xv, Xv, Xv, Xv
Xv, Xv, Xv, Gg^Vh, Re, Hh, Re, Gs^Fp, Rd, Ce, Tb^Tf, Mm^Xm, Hh, Gs^Fp, Gg, Rd, Hh, Re, Re, Gs^Fp, Rd, Re, Rp, Xv, Xv, Xv, Xv
Xv, Xv, Re, Re, Hh, Re, Rd, Re, Re, Re, Re, Gs^Fp, Wwf, Gg, Rd, Rd, Gs^Fp, Mm, Re, Rd, Re, Rd, Gg^Fet, Rp, Xv, Xv, Xv
Gg, Rp, Rp, Hh, Gs^Fp, Rd, Gs^Fp, Hh, Rr, Rr, Rr, Wwf, Ss^Vhs, Wwf, Rp, Rd, Rd, Re, Rr, Re, Rr, Rd, Rd, Rp, Xv, Xv, Xv
Mm, Gs^Fp, Rp, Mm^Xm, Hh^Vhh, Rd, Ss, Rr, Wwf, Wwf, Ww, Wwf, Tb^Tf, Gs^Fp, Ds, Rd, Ss, Re, Chw, Rr, Gs^Fp, Mm, Gg, Rp, Rp, Xv, Gs^Fp
Mm, Hh, Rp, Rd, Rd, Rd, Rr, Rr, Wwf, Ww^Vm, Wo, Mm^Xm, Chs, Mm^Xm, Mm^Xm, Uh, Mm^Xm, Wwf, Ww^Bw/, Rr, Rr, Hh, Gg, Gg, Rp, Mm, Hh
Rp, Rp, Hh, Gs^Fp, Gg, Gg^Efm, Rr, Wwf, Ww, Ww, Mm^Xm, Mm^Xm, Khs, Ql, Mm^Xm, Tb^Tf, Chw, Wo^Bw/, Ww, Chw, Re, Re, Re, Gg^Efm, Re, Rp, Rp
Rp, Mm^Xm, Re, Re, Re, Gg^Ve, Re, Rr, Ww, Uh, Chw, Chr, Mm^Xm, Mm^Xm, Khs, Chr, Mm^Xm, Uh, Ww, Rr, Rr, Gg^Ve, Gg, Re, Hh, Mm^Xm, Rp
Hh, Rp, Rp, Gg^Efm, Gg, Re, Rr, Chw, Ww^Bw/, Wo^Bw/, Mm^Xm, Tb^Tf, Mm^Xm, Ql, Chs, Mm^Xm, Wo, Ww, Wwf, Wwf, Rr, Gg^Efm, Rd, Gs^Fp, Rp, Rp, Mm
Gs^Fp, Mm, Rp, Gg, Gg, Hh, Gs^Fp, Rr, Chw, Wwf, Ss, Uh, Ds, Mm^Xm, Tb^Tf, Mm^Xm, Ww, Ww^Vm, Wwf, Rr, Ss, Rd, Hh^Vhh, Rd, Rp, Hh, Mm
Xv, Xv, Xv, Rp, Rd, Mm, Rr, Rr, Rr, Re, Rd, Rd, Rp, Gs^Fp, Ss^Vhs, Wwf, Rr, Wwf, Rr, Rr, Gs^Fp, Rd, Gs^Fp, Mm^Xm, Rp, Gs^Fp, Gg
Xv, Xv, Xv, Rp, Gg^Fet, Rd, Re, Re, Re, Re, Gs^Fp, Rd, Rd, Wwf, Wwf, Wwf, Re, Rr, Re, Hh, Rd, Rd, Hh, Hh, Re, Rp, Xv
Xv, Xv, Xv, Rp, Rp, Rd, Rd, Rd, Re, Hh, Mm, Rd, Gg, Gg, Hh, Gs^Fp, Tb^Tf, Re, Rd, Re, Re, Re, Re, Re, Xv, Xv, Xv
Xv, Xv, Xv, Xv, Xv, Re, Rd, Gs^Fp, Gs^Fp, Re, Rd, Rd, Rd, Gs^Fp, Hh, Mm^Xm, 1 Ke, Ce, Hh, Gs^Fp, Hh, Hh, Gs^Fp, Gg^Vh, Xv, Xv, Xv
Xv, Xv, Xv, Xv, Xv, Xv, Rr, Hh, Rr, Rr, Rr, Rr, Rd, Uu^Vud, Rd, Ce, Ce, Ss, Xv, Xv, Xv, Xv, Xv, Xv, Xv, Xv, Xv
Xv, Xv, Xv, Xv, Xv, Xv, Xv, Rr, Gs^Fp, Gg^Vc, Rr, Rd, Gs^Fp, Rd, Re, Rd, Xv, Xv, Xv, Xv, Xv, Xv, Xv, Xv, Xv, Xv, Xv
Xv, Xv, Xv, Xv, Xv, Xv, Xv, Xv, Xv, Hh, Xv, Mm, Xv, Re, Xv, Xv, Xv, Xv, Xv, Xv, Xv, Xv, Xv, Xv, Xv, Xv, Xv
Xv, Xv, Xv, Xv, Xv, Xv, Xv, Xv, Xv, Xv, Xv, Xv, Xv, Xv, Xv, Xv, Xv, Xv, Xv, Xv, Xv, Xv, Xv, Xv, Xv, Xv, Xv
Xv, Xv, Xv, Xv, Xv, Xv, Xv, Xv, Xv, Xv, Xv, Xv, Xv, Xv, Xv, Xv, Xv, Xv, Xv, Xv, Xv, Xv, Xv, Xv, Xv, Xv, Xv
