Ms^Xm, Aa, Ms^Xm, Aa, Ms^Xm, Ms^Xm, Ms^Xm, Ms^Xm, Ms^Xm, Xu, Xu, Wog, Wog, Xuc, Xuc, Xu, Xuc, Xu, Xu, Xu, Xuc, Xu, Xu, Xu, Xu, Xu, Xu, Xu, Xu, Xu, Xu, Xu, Xu, Xu, Xu, Xu, Xu, Xu, Xu, Xu, Xu, Xu, Xu, Ms^Xm, Ms^Xm, Ms^Xm, Ms^Xm, Ms^Xm, Ms^Xm, Ms^Xm, Ms^Xm, Ms^Xm, Ms^Xm, Ms^Xm, Ms^Xm
Ms^Xm, Ms^Xm, Ms^Xm, Ms^Xm, Ms^Xm, Ms^Xm, Ms^Xm, Ms^Xm, Ms^Xm, Ms^Xm, Xu, Wog, Wog, Wog, Wwg, Xuc^Efs, Ww, Xuc^Efs, Xuc, Xuc, Ww, Xuc, Xuc, Xu, Xu, Xu, Xu, Xu, Xu, Xu, Xu, Xu, Uu^Vud, Xu, Xu, Xu, Xu, Xu, Xu, Xu, Xu^Efs, Xu, Xu, Xu, Ms^Xm, Ms^Xm, Ms^Xm, Ms^Xm, Ms^Xm, Ms^Xm, Ms^Xm, Ms^Xm, Ms^Xm, Ms^Xm, Ms^Xm
Ms^Xm, Ms^Xm, Ms^Xm, Ms^Xm, Ms^Xm, Ms^Xm, Ms^Xm, Ms^Xm, Ms^Xm, Ms^Xm, Ms^Xm, Xu, Xu, Wwg, Wwg, Wog, Uh, Cud, Wwf, Wwf, Gll^Emf, Ww, Ww, Uu, Cud, Xom, Xom, Xu, Xom, Xom, Cud, Urb^Br\, Urb^Br\, Uu, Uu^Br|, Uh, Uu, Xu, Uu^Tf, Uu, Uu, Xu, Xu, Xu, Ms^Xm, Ms^Xm, Ms^Xm, Ms^Xm, Ms^Xm, Ms^Xm, Ms^Xm, Ms^Xm, Ms^Xm, Ms^Xm, Ms^Xm
Ms^Xm, Ms^Xm, Ms^Xm, Ms^Xm, Ms^Xm, Ms^Xm, Ms^Xm, Ms^Xm, Ms^Xm, Ms^Xm, Ms^Xm, Ms^Xm, Xu, Uu, Wwg, Wog, Wog, Wwf, Gll^Emf, Gll^Emf, Wwf, Wwf, Gll^Emf, Uu, Cud, Xom^Efs, Xom^Efs, Xom, Xom^Efs, Xom^Efs, Cud, Uu, Urb^Br|, Urb^Br\, Urb^Br\, Uu, Uu^Ii, Uu, Urb^Br/, Urb^Br/, Uh, Xu, Xu, Xu, Ms^Xm, Ms^Xm, Ms^Xm, Ms^Xm, Ms^Xm, Ms^Xm, Ms^Xm, Ms^Xm, Ms^Xm, Ms^Xm, Ms^Xm
Ms^Xm, Ms^Xm, Ms, Ms^Xm, Ms, Ms^Xm, Ms^Xm, Ms^Xm, Ms^Xm, Ms^Xm, Ms^Xm, Ms^Xm, Xu, Uu, Wwg, Wog, Wwg, Wwg, Wwg, Wwf, Gll^Emf, Gll^Emf, Wwf, Uu, Cud, Cud, Cud, 4 Kud, Cud, Cud, Cud, Uu, Urb^Br|, Uu, Uu, Urb^Br\, Urb^Br\, Urb^Br|, Uh, Uh, Xu, Xu, Xu, Ms^Xm, Ms^Xm, Ms^Xm, Ms^Xm, Ms^Xm, Ms^Xm, Ms^Xm, Ms, Ms^Xm, Ms, Ms^Xm, Ms
Ms, Ms, Ha, Ha, Ha, Ms, Ms, Ms^Xm, Ms^Xm, Ms^Xm, Ms^Xm, Ms^Xm, Xu, Uu^Tf, Wwg, Wwg, Wwg^Ii, Wwg^Ii, Wwg^Ii, Wwg, Wwf, Wwf, Gll^Emf, Uu, Uu, Cud^Ebn, Uu, Cud, Uu, Cud^Ebn, Uu, Uu, Urb^Br|, Uu, Uu^Ii, Uu, Uh, Urb^Br\, Urb^Br\, Uu^Vu, Uh, Xu, Xu, Ms^Xm, Ms^Xm, Ms^Xm, Ms^Xm, Ms^Xm, Ms, Ms, Ha, Ha, Ha, Ms, Ms
Ha, Ha, Ha, Ha, Ha, Ms, Ms, Ms^Xm, Ms^Xm, Ms^Xm, Ms^Xm, Ms^Xm, Xu, Wwf, Wwg, Wwg, Wwg^Ii, Wwg^Ii, Wwg^Ii, Wwg, Uu^Tf, Gll^Emf, Uu, Uu, Uu^Vud, Uu, Ur, Urb, Ur, Uu, Uu^Vud, Uu, Urb^Br\, Uu^Vud, Ur, Uu, Xuc, Uh, Uu, Urb^Br|, Uu, Xu, Xu, Ms^Xm, Ms^Xm, Ms^Xm, Ms^Xm, Ms, Ms, Ms, Ha, Ha, Ha, Ha, Ha
Ha, Ha, Aa, Aa, Aa, Ha, Ms, Ms^Xm, Ms^Xm, Ms^Xm, Xu, Xu, Xuc, Xuc, Cud, Wwg, Wwg, Wwg^Ii, Wwg, Wwg, Wwg, Xuc^Efs, Xuc, Uu, Ur, Ur, Cud, Urb, Cud, Ur, Ur, Uu, Xuc, Xuc^Efs, Ur, Uu, Uu, Uh, Uu, Urb^Br|, Xuc^Efs, Xuc, Xuc, Xu, Xu, Xu, Xu, Ms^Xm, Ms, Ha, Aa, Aa, Aa, Ha, Ha
Aa, Aa, Aa, Aa, Aa, Ha, Ha, Ms, Ms^Xm, Ms^Xm, Xu, Uh, Uh, Xuc^Efs, Wwg, Cud^Ebn, Cud, Wwg, Xuc, Wwg, Cud^Ii, Cud, Ur, Uu^Vud, Ur, Uu^Ebn, Urb^Ii, Urb, Urb, Uu^Ebn, Ur, Uu^Vud, Ur, Cud, Cud^Ii, Uu, Xuc, Uu, Xuc, Urb^Br|, Uh, Xuc, Uh, Uh, Xu, Xu, Xu, Ms^Xm, Ha, Ha, Aa, Aa, Aa, Aa, Aa
Aa, Aa, Aa, Aa, Aa, Aa, Ha, Ms, Ms, Ms^Xm, Xu, Uh, Uu, Wwg, Uu, Uu, Uh, Xuc^Efs, Xuc, Cud, Wwg, Uh, Uh, Ur, Uu, Ur, Cud, Urb, Cud, Ur, Uu, Ur, Uh, Uh, Uu, Cud, Xuc, Xuc^Efs, Uh, Urb^Br|, Uu, Uu, Uu^Tfi, Uu, Xu, Xu, Ms^Xm, Ms^Xm, Ha, Aa, Aa, Aa, Aa, Aa, Aa
Aa, Aa, Aa, Aa, Aa, Aa, Ha, Ha, Ha, Ms, Xu, Uu, Uu, Wwg, Uu, Uu, Uu, Uh, Uh, Uh, Wwg, Uh, Uu, Uu, Uu, Uu, Urb, Urb, Urb^Ii, Uu, Uu^Tf, Uu, Uu, Uh, Uu, Uh, Uh, Uh^Ii, Uu, Urb^Br|, Urb^Br\, Uu^Vu, Uu, Uu, Xu, Ms^Xm, Ms^Xm, Ms^Xm, Aa, Aa, Aa, Aa, Aa, Aa, Aa
Aa, Aa, Gd, Gd, Re, Aa, Ha, Ha, Ha, Ha, Uh, Uu, Uu, Wwg, Uu, Cud, Uu, Uu, Wwg, Wwg, Uu, Uu, Uu, Uh, Xuc, Uu^Ebn, Urb, Urb, Urb, Uu^Ebn, Xuc, Uh, Uu, Uu^Vud, Urb^Br\, Uu, Uu, Uu, Urb^Br/, Urb^Br|, Uu, Urb^Br\, Urb^Br\, Uh, Uh, Ha, Ha, Aa, Aa, Aa, Re, Gd, Gd, Aa, Aa
Aa, Re, Ce, Ce, Ce, Aa, Aa, Ha, Ha, Ha, Ha, Uh, Uu, Wwg, Uu, Uh, Wwg, Wwg, Uu, Uu, Uu^Vu, Uu^Tf, Uu, Uu, Xuc, Cud, Urb^Ii, Urb, Urb, Cud, Xuc, Xuc, Xuc^Efs, Uu, Uu, Urb^Br\, Urb^Br\, Urb^Br/, Xuc, Urb^Br|, Uu, Uu, Uh, Urb^Br\, Ha^Br\, Ha, Ha, Aa, Aa, Aa, Ce, Ce, Ce, Re, Aa
Aa, Re, Ce, 2 Ke, Ce, Ce, Aa, Ha, Ha^Vhha, Ha, Ha, Uh, Xu, Wwg, Uh, Wwg, Uu, Uu, Cud, Uu, Uu, Uu, Uh, Uu, Xuc^Efs, Uu^Vud, Urb, Urb, Urb, Uu^Vud, Xuc^Efs, Xuc, Uh, Uu, Uu, Uu^Ebn, Cud, Urb^Br\, Urb^Br\, Urb^Br|, Uu, Uh, Xu, Xu, Ha, Ha^Br\, Ha^Vhha, Ha, Aa, Ce, Ce, 3 Ke, Ce, Re, Aa
Aa, Re, Gd, Ce, Ce, Ce, Re, Aa, Ha, Ha, Aa, Ha, Wwg, Wwg, Xu, Wwg, Uu, Uu, Uh, Cud, Uu, Uh, Xuc, Xuc, Qxu, Cud, Urb, Urb, Urb^Ii, Cud, Qxu, Xuc, Xuc, Uh, Uu, Cud, Uh, Uu, Uu, Urb^Br|, Uh, Xu, Ms^Xm, Ms^Xm, Ms^Xm, Ha, Ha, Aa, Re, Ce, Ce, Ce, Gd, Re, Aa
Aa, Aa, Aa^Vca, Re, Re, Gd, Re, Aa, Aa^Fpa, Aa^Fpa, Aa, Wwg, Ha, Ha, Wwg, Wwg, Uh, Uu, Uu, Uh, Xu, Xuc, Xu, Uu, Uu^Vu, Qxu, Urb^Ii, Urb, Urb, Qxu, Uu^Vu, Uu, Xu, Xuc, Xu, Uh, Uu, Uu, Uu, Urb^Br|, Uh, Ha, Ha, Ms^Xm, Ha, Ha^Fpa, Aa^Fpa, Aa, Re, Gd, Re, Re, Aa^Vca, Aa, Aa
Aa, Aa, Aa, Aa, Aa, Aa, Aa, Re, Aa, Aa^Fpa, Aa, Wwg, Ha, Ha, Wwg, Hhd, Hhd, Uh, Uh, Xu, Ms^Xm, Xu, Xu, Uu, Uue, Uu^Tf, Uu, Urb, Uu, Uu^Tf, Uue, Uu, Xu, Xu, Ms^Xm, Xu, Xu, Uu, Uh, Urb^Br\, Ha^Br\, Ha, Ha, Ha, Ha, Ha^Fpa, Aa, Re, Aa, Aa, Aa, Aa, Aa, Aa, Aa
Aa, Aa, Aa, Aa, Aa, Aa, Aa^Fpa, Aa, Aa, Re, Wwg^Bw\, Wwg, Aa^Vca, Wwg, Aa, Ha, Ha, Hhd, Ha, Ms^Xm, Ms^Xm, Ms^Xm, Ms^Xm, Xu, Xu, Uue, Uue, Urb, Uue, Uue^Ii, Xu, Xu, Ms^Xm, Ms^Xm, Ms^Xm, Ms^Xm, Ms^Xm, Xu, Ha, Ha, Aa, Ha^Br\, Ha^Vhha, Aa, Rd, Rd, Aa, Aa, Aa^Fpa, Aa, Aa, Aa, Aa, Aa, Aa
Aa, Aa, Aa, Aa, Aa, Aa, Aa, Aa, Aa, Aa, Wwg, Aa, Wwg^Bw\, Wwg, Aa, Aa, Aa, Ha, Aa, Aa, Aa, Ms^Xm, Ha, Ms^Xm, Xu, Uue^Ii, Re, Ur, Re, Re, Xu, Ms^Xm, Ms, Ms^Xm, Ha, Ms^Xm, Aa, Ha, Aa, Aa, Aa, Aa, Ha, Ha, Ms, Aa, Aa, Aa, Aa, Aa, Aa, Aa, Aa, Aa, Aa
Aa, Aa, Aa, Aa, Aa, Aa, Aa, Aa, Aa, Wwg, Wwg, Wwg, Aa, Re, Re, Gd, Gd^Fp, Aa, Aa, Aa, Aa, Aa, Aa, Ha, Gd, Re, Re, Ur, Rd, Rd, Re, Ha, Ha, Ha, Aa, Aa, Aa, Aa, Gd^Fp, Gd, Re, Re, Aa, Ms, Ms, Ms, Ha, Aa, Aa, Aa, Aa, Aa, Ha, Ha, Ha
Wwg, Wwg, Wwg, Aa, Aa, Aa, Aa, Aa, Ai, Wwg, Ai, Ai, Gd, Rb, Gd^Fp, Re, Re, Re, Re, Aa, Aa, Aa, Aa, Rd, Gd, Re, Re, Rp, Gd, Gd, Gd, Gd, Aa, Aa, Aa, Aa, Re, Re, Re, Re, Gd^Fp, Rb, Rd, Ha, Ha, Ms, Ms, Ha, Ha, Aa, Ha, Ha, Ms, Ms, Ms
Wwg, Wwg, Ai, Wwg, Wwg, Aa, Wwg, Ai, Wwg, Wwg, Ai, Aa, Aa, Gd, Gd^Fp, Aa^Fp, Aa^Fpa, Aa^Fpa, Aa, Re, Re, Aa, Re, Re, Re, Gd, Rd, Rp, Rd, Rd, Re, Re, Re, Aa, Re, Re, Aa, Aa^Fpa, Aa^Fpa, Aa^Fp, Gd^Fp, Gd, Aa, Aa, Ha, Ms, Ms, Ms, Ms, Ha, Ms, Ms, Ha, Ms, Ms
Ai, Aa, Aa, Ai, Wwg, Wwg, Wwg, Wwg, Wwg, Wwg, Aa, Aa, Aa, Aa^Fpa, Aa^Fpa, Aa^Fp, Aa^Fpa, Aa, Aa, Aa, Re^Vct, Re^Vct, Cea, Re^Vct, Ce, Re, Re, Re, Re, Re, Ce, Re^Vct, Cea, Re^Vct, Re^Vct, Aa, Aa, Aa, Aa^Fpa, Aa^Fp, Aa^Fpa, Aa^Fpa, Aa, Aa, Aa, Ms, Ms, Ms, Ms, Ms, Ms, Ha, Aa, Ha, Ha
Ai, Ai, Ai, Ai, Ai, Ai, Ai, Ai, Aa, Aa, Aa, Aa, Aa, Aa^Fpa, Aa^Fpa, Aa^Fpa, Aa, Aa, Aa, Aa, Aa, Re^Vct, Ke, Cea, Ce, Ce, Cea, Cea, Cea, Ce, Ce, Cea, Ke, Re^Vct, Aa, Aa, Aa, Aa, Aa, Aa^Fpa, Aa^Fpa, Aa^Fpa, Aa, Aa, Aa, Aa, Aa, Ha, Ha, Ha, Ha, Ha, Ha, Ha, Ha
Aa, Aa, Aa, Aa, Aa, Aa, Ai, Ai, Aa, Aa, Aa, Aa, Aa, Aa, Aa, Aa, Aa, Aa, Aa, Aa, Aa, Aa, Re, Re, Aa, Aa, Re, 1 Ke, Re, Aa, Aa, Re, Re, Aa, Aa, Aa, Aa, Aa, Aa, Aa, Aa, Aa, Aa, Aa, Aa, Aa, Aa, Ha, Ha, Aa, Aa, Aa, Aa, Aa, Aa
Aa, Aa, Aa, Aa, Aa, Aa, Aa, Aa, Aa, Aa, Aa, Aa, Aa, Aa, Aa, Aa, Aa, Aa, Aa, Aa, Aa, Aa, Aa, Gd, Gd, Gd, Re, Rp, Gd, Gd, Gd, Gd, Aa, Aa, Aa, Aa, Aa, Aa, Aa, Aa, Aa, Aa, Aa, Aa, Aa, Aa, Aa, Aa, Aa, Aa, Aa, Aa, Aa, Aa, Aa
Aa, Aa, Aa, Aa, Aa, Aa, Aa, Aa, Aa, Aa, Aa, Aa, Aa, Aa, Aa, Aa, Aa, Aa, Aa, Aa, Aa, Aa, Aa, Aa, Aa, Gd, Gd, Rp, Gd, Re, Aa, Aa, Aa, Aa, Aa, Aa, Aa, Aa, Aa, Aa, Aa, Aa, Aa, Aa, Aa, Aa, Aa, Aa, Aa, Aa, Aa, Aa, Aa, Aa, Aa
