border_size=1
usage=map

Ms^Xm, Aa, Ms^Xm, Aa, Ms^Xm, Ms^Xm, Ms^Xm, Ms^Xm, Ms^Xm, Xu, Xu, Ww, Ww, Xu, Xu, Xu, Xu, Xu, Xu, Xu, Xu, Xu, Xu, Xu, Xu, Xu, Xu, Xu, Xu, Xu, Xu, Xu, Xu, Xu, Xu, Xu, Xu, Xu, Xu, Xu, Xu, Xu, Xu, Ms^Xm, Ms^Xm, Ms^Xm, Ms^Xm, Ms^Xm, Ms^Xm, Ms^Xm, Ms^Xm, Ms^Xm, Ms^Xm, Ms^Xm, Ms^Xm
Ms^Xm, Ms^Xm, Ms^Xm, Ms^Xm, Ms^Xm, Ms^Xm, Ms^Xm, Ms^Xm, Ms^Xm, Ms^Xm, Xu, Ww, Ww, Ww, Ww, Uu, Ww, Ww, Ww, Ww, Ww, Uu, Uu, Uh, Cud, Cud, Cud, Cud, Cud, Cud, Cud, Uh, Uu^Vud, Uu, Uu, Uh, Uh, Xu, Xu, Uh, Uu, Xu, Xu, Ms^Xm, Ms^Xm, Ms^Xm, Ms^Xm, Ms^Xm, Ms^Xm, Ms^Xm, Ms^Xm, Ms^Xm, Ms^Xm, Ms^Xm, Ms^Xm
Ms^Xm, Ms^Xm, Ms^Xm, Ms^Xm, Ms^Xm, Ms^Xm, Ms^Xm, Ms^Xm, Ms^Xm, Ms^Xm, Ms^Xm, Xu, Xu, Ww, Ww, Ww, Uh, Cud, Wwf, Wwf, Gll^Emf, Ww, Ww, Uu, Cud, Cud, Xos, Cud, Xos, Cud, Cud, Urb^Br\, Urb^Br\, Uu, Uu^Br|, Uu^Br/, Uu, Xu, Uu^Uf, Uu, Uu^Br/, Uh, Xu, Ms^Xm, Ms^Xm, Ms^Xm, Ms^Xm, Ms^Xm, Ms^Xm, Ms^Xm, Ms^Xm, Ms^Xm, Ms^Xm, Ms^Xm, Ms^Xm
Ms^Xm, Ms^Xm, Ms^Xm, Ms^Xm, Ms^Xm, Ms^Xm, Ms^Xm, Ms^Xm, Ms^Xm, Ms^Xm, Ms^Xm, Ms^Xm, Xu, Uu, Ww, Ww, Ww, Wwf, Gll^Emf, Gll^Emf, Wwf, Wwf, Gll^Emf, Uu, Cud, Xos^Efs, Xos^Efs, Xos, Xos^Efs, Xos^Efs, Cud, Uu, Urb^Br|, Urb^Br\, Urb^Br\, Uu, Uu^Ii, Uu, Urb^Br/, Urb^Br/, Uh, Uu, Xu, Ms^Xm, Ms^Xm, Ms^Xm, Ms^Xm, Ms^Xm, Ms^Xm, Ms^Xm, Ms^Xm, Ms^Xm, Ms^Xm, Ms^Xm, Ms^Xm
Ms^Xm, Ms^Xm, Ms, Ms^Xm, Ms, Ms^Xm, Ms^Xm, Ms^Xm, Ms^Xm, Ms^Xm, Ms^Xm, Ms^Xm, Xu, Uu, Ww, Ww, Ww, Ww, Ww, Wwf, Gll^Emf, Gll^Emf, Wwf, Uu, Cud, Cud, Cud, 4 Kud, Cud, Cud, Cud, Uu, Urb^Br|, Uu, Uu, Urb^Br\, Urb^Br\, Urb^Br|, Uh, Uh, Xu, Xu, Xu, Ms^Xm, Ms^Xm, Ms^Xm, Ms^Xm, Ms^Xm, Ms^Xm, Ms^Xm, Ms, Ms^Xm, Ms, Ms^Xm, Ms
Ms, Ms, Ha, Ha, Ha, Ms, Ms, Ms^Xm, Ms^Xm, Ms^Xm, Ms^Xm, Ms^Xm, Xu, Uu^Uf, Ww, Ww, Ww^Ii, Ww^Ii, Ww^Ii, Ww, Wwf, Wwf, Gll^Emf, Uu, Uu, Cud, Uu, Cud, Uu, Cud, Uu, Uu, Urb^Br|, Uu, Uu^Ii, Uu, Uh, Urb^Br\, Urb^Br\, Uu^Vu, Uh, Xu, Xu, Ms^Xm, Ms^Xm, Ms^Xm, Ms^Xm, Ms^Xm, Ms, Ms, Ha, Ha, Ha, Ms, Ms
Ha, Ha, Ha, Ha, Ha, Ms, Ms, Ms, Ms, Ms^Xm, Ms^Xm, Ms^Xm, Xu, Wwf, Ww, Ww, Ww^Ii, Ww^Ii, Ww^Ii, Ww, Uu^Uf, Gll^Emf, Uu, Uu, Uu^Vud, Uu, Ur, Urb, Ur, Uu, Uu^Vud, Uu, Urb^Br\, Uu^Vud, Ur, Uu, Xu, Uh, Uu, Urb^Br|, Uu, Xu, Xu, Ms^Xm, Ms^Xm, Ms^Xm, Ms, Ms, Ms, Ms, Ha, Ha, Ha, Ha, Ha
Ha, Ha, Aa, Aa, Aa, Ha, Ms, Ms, Ms, Ms, Xu, Xu, Xu, Xu, Cud, Ww, Ww, Ww^Ii, Ww, Ww, Ww, Xu, Xu, Uu, Ur, Ur, Cud, Urb, Cud, Ur, Ur, Uu, Xu, Xu, Ur, Uu, Uu, Uh, Uu, Urb^Br|, Xu, Xu, Xu, Xu, Xu, Ms, Ms, Ms, Ms, Ha, Aa, Aa, Aa, Ha, Ha
Aa, Aa, Aa, Aa, Aa, Ha, Ha, Ms, Ms, Ms, Xu, Uh, Uh, Xu, Ww, Cud, Cud, Ww, Xu, Ww, Cud^Ii, Cud, Ur, Uu^Vud, Ur, Uu, Urb^Ii, Urb, Urb, Uu, Ur, Uu^Vud, Ur, Cud, Cud^Ii, Uu, Xu, Uu, Xu, Urb^Br|, Uh, Xu, Uh, Uh, Xu, Ms, Ms, Ms, Ha, Ha, Aa, Aa, Aa, Aa, Aa
Aa, Aa, Aa, Aa, Aa, Aa, Ha, Ms, Ms, Ms, Xu, Uh, Uu, Ww, Uu, Uu, Uh, Xu, Xu, Cud, Ww, Uh, Uh, Ur, Uu, Ur, Cud, Urb, Cud, Ur, Uu, Ur, Uh, Uh, Uu, Cud, Xu, Xu, Uh, Urb^Br|, Uu, Uu, Uu^Ufi, Uu, Xu, Ms, Ms, Ms, Ha, Aa, Aa, Aa, Aa, Aa, Aa
Aa, Aa, Aa, Aa, Aa, Aa, Ha, Ha, Ha, Ms, Xu, Uu, Uu, Ww, Uu, Uu, Uu, Uh, Uh, Uh, Ww, Uh, Uu, Uu, Uu, Uu, Urb, Urb, Urb^Ii, Uu, Uu^Uf, Uu, Uu, Uh, Uu, Uh, Uh, Uh^Ii, Uu, Urb^Br|, Urb^Br\, Uu^Vu, Uu, Uu, Xu, Ms, Ha, Ha, Aa, Aa, Aa, Aa, Aa, Aa, Aa
Aa, Aa, Gd, Gd, Re, Aa, Ha, Ha, Ha, Ha, Uh, Uu, Uu, Ww, Uu, Cud, Uu, Uu, Ww, Ww, Uu, Uu, Uu, Uh, Xu, Uu, Urb, Urb, Urb, Uu, Xu, Uh, Uu, Uu^Vud, Urb^Br\, Uu, Uu, Uu, Urb^Br/, Urb^Br|, Uu, Urb^Br\, Urb^Br\, Uh, Uh, Ha, Ha, Aa, Aa, Aa, Re, Gd, Gd, Aa, Aa
Aa, Re, Ce, Ce, Ce, Aa, Aa, Ha, Ha, Ha, Ha, Uh, Uu, Ww, Uu, Uh, Ww, Ww, Uu, Uu, Uu^Vu, Uu^Uf, Uu, Uu, Xu, Cud, Urb^Ii, Urb, Urb, Cud, Xu, Xu, Xu, Uu, Uu, Urb^Br\, Urb^Br\, Urb^Br/, Xu, Urb^Br|, Uu, Uu, Uh, Urb^Br\, Ha^Br\, Ha, Ha, Aa, Aa, Aa, Ce, Ce, Ce, Re, Aa
Aa, Re, Ce, 2 Ke, Ce, Ce, Aa, Ha, Ha^Vhha, Ha, Ha, Uh, Xu, Ww, Uh, Ww, Uu, Uu, Cud, Uu, Uu, Uu, Uh, Uu, Xu, Uu^Vud, Urb, Urb, Urb, Uu^Vud, Xu, Xu, Uh, Uu, Uu, Uu, Cud, Urb^Br\, Urb^Br\, Urb^Br|, Uu, Uh, Xu, Xu, Ha, Ha^Br\, Ha^Vhha, Ha, Aa, Ce, Ce, 3 Ke, Ce, Re, Aa
Aa, Re, Gd, Ce, Ce, Ce, Re, Aa, Ha, Ha, Aa, Ha, Ww, Ww, Xu, Ww, Uu, Uu, Uh, Cud, Uu, Uh, Xu, Xu, Qxu, Cud, Urb, Urb, Urb^Ii, Cud, Qxu, Xu, Xu, Uh, Uu, Cud, Uh, Uu, Uu, Urb^Br|, Uh, Xu, Ha, Ha, Ha, Ha, Ha, Aa, Re, Ce, Ce, Ce, Gd, Re, Aa
Aa, Aa, Aa^Vca, Re, Re, Gd, Re, Aa, Aa^Fpa, Aa^Fpa, Aa, Ww, Ha, Ha, Ww, Ww, Uh, Uu, Uu, Uh, Xu, Xu, Uue, Uu, Uu^Vu, Qxu, Urb^Ii, Urb, Urb, Qxu, Uu^Vu, Uu, Uue, Xu, Xu, Uh, Uu, Uu, Uu, Urb^Br|, Uh, Ha, Ha, Ha, Ha, Ha^Fpa, Aa^Fpa, Aa, Re, Gd, Re, Re, Aa^Vca, Aa, Aa
Aa, Aa, Aa, Aa, Aa, Aa, Aa, Re, Aa, Aa^Fpa, Aa, Ww, Ha, Ha, Ww, Hhd, Hhd, Uh, Uh, Xu, Ha, Xu, Xu, Uu, Uue, Uu^Uf, Uu, Urb, Uu, Uu^Uf, Uue, Uu, Xu, Xu, Ha, Xu, Xu, Uu, Uh, Urb^Br\, Ha^Br\, Ha, Ha, Ha, Ha, Ha^Fpa, Aa, Re, Aa, Aa, Aa, Aa, Aa, Aa, Aa
Aa, Aa, Aa, Aa, Aa, Aa, Aa^Fpa, Aa, Aa, Re, Ww^Bw\, Ww, Aa^Vca, Ww, Aa, Ha, Ha, Hhd, Ha, Ha, Ha, Ha, Ha, Xu, Xu, Uue, Uue, Urb, Uue, Uue^Ii, Xu, Xu, Ha, Ha, Ha, Ha, Ha, Xu, Ha, Ha, Aa, Ha^Br\, Ha^Vhha, Aa, Rd, Rd, Aa, Aa, Aa^Fpa, Aa, Aa, Aa, Aa, Aa, Aa
Aa, Aa, Aa, Aa, Aa, Aa, Aa, Aa, Aa, Aa, Ww, Aa, Ww^Bw\, Ww, Aa, Aa, Aa, Ha, Aa, Aa, Aa, Aa, Aa, Aa, Xu, Uue^Ii, Re, Ur, Re, Re, Xu, Aa, Aa, Aa, Aa, Aa, Aa, Ha, Aa, Aa, Aa, Aa, Ha, Ha, Ms, Aa, Aa, Aa, Aa, Aa, Aa, Aa, Aa, Aa, Aa
Aa, Aa, Aa, Aa, Aa, Aa, Aa, Aa, Aa, Ww, Ww, Ww, Aa, Re, Re, Gd, Gd^Fp, Aa, Aa, Aa, Aa, Aa, Aa, Rd, Gd, Re, Re, Ur, Rd, Rd, Re, Gd, Aa, Aa, Aa, Aa, Aa, Aa, Gd^Fp, Gd, Re, Re, Aa, Ms, Ms, Ms, Ha, Aa, Aa, Aa, Aa, Aa, Ha, Ha, Ha
Ww, Ww, Ww, Aa, Aa, Aa, Aa, Aa, Ai, Ww, Ai, Ai, Gd, Rb, Gd^Fp, Re, Re, Re, Re, Aa, Aa, Aa, Aa, Rd, Gd, Re, Re, Rp, Gd, Gd, Gd, Gd, Aa, Aa, Aa, Aa, Re, Re, Re, Re, Gd^Fp, Rb, Rd, Ha, Ha, Ms, Ms, Ha, Ha, Aa, Ha, Ha, Ms, Ms, Ms
Ww, Ww, Ai, Ww, Ww, Aa, Ww, Ai, Ww, Ww, Ai, Aa, Aa, Gd, Gd^Fp, Aa^Fp, Aa^Fpa, Aa^Fpa, Aa, Re, Re, Aa, Re, Re, Re, Gd, Rd, Rp, Rd, Rd, Re, Re, Re, Aa, Re, Re, Aa, Aa^Fpa, Aa^Fpa, Aa^Fp, Gd^Fp, Gd, Aa, Aa, Ha, Ms, Ms, Ms, Ms, Ha, Ms, Ms, Ha, Ms, Ms
Ai, Aa, Aa, Ai, Ww, Ww, Ww, Ww, Ww, Ww, Aa, Aa, Aa, Aa^Fpa, Aa^Fpa, Aa^Fp, Aa^Fpa, Aa, Aa, Aa, Re^Vct, Re^Vct, Cea, Re^Vct, Ce, Re, Re, Re, Re, Re, Ce, Re^Vct, Cea, Re^Vct, Re^Vct, Aa, Aa, Aa, Aa^Fpa, Aa^Fp, Aa^Fpa, Aa^Fpa, Aa, Aa, Aa, Ms, Ms, Ms, Ms, Ms, Ms, Ha, Aa, Ha, Ha
Ai, Ai, Ai, Ai, Ai, Ai, Ai, Ai, Aa, Aa, Aa, Aa, Aa, Aa^Fpa, Aa^Fpa, Aa^Fpa, Aa, Aa, Aa, Aa, Aa, Re^Vct, Ke, Cea, Ce, Ce, Cea, Cea, Cea, Ce, Ce, Cea, Ke, Re^Vct, Aa, Aa, Aa, Aa, Aa, Aa^Fpa, Aa^Fpa, Aa^Fpa, Aa, Aa, Aa, Aa, Aa, Ha, Ha, Ha, Ha, Ha, Ha, Ha, Ha
Aa, Aa, Aa, Aa, Aa, Aa, Ai, Ai, Aa, Aa, Aa, Aa, Aa, Aa, Aa, Aa, Aa, Aa, Aa, Aa, Aa, Aa, Re, Re, Aa, Aa, Re, 1 Ke, Re, Aa, Aa, Re, Re, Aa, Aa, Aa, Aa, Aa, Aa, Aa, Aa, Aa, Aa, Aa, Aa, Aa, Aa, Ha, Ha, Aa, Aa, Aa, Aa, Aa, Aa
Aa, Aa, Aa, Aa, Aa, Aa, Aa, Aa, Aa, Aa, Aa, Aa, Aa, Aa, Aa, Aa, Aa, Aa, Aa, Aa, Aa, Aa, Aa, Gd, Gd, Gd, Re, Rp, Gd, Gd, Gd, Gd, Aa, Aa, Aa, Aa, Aa, Aa, Aa, Aa, Aa, Aa, Aa, Aa, Aa, Aa, Aa, Aa, Aa, Aa, Aa, Aa, Aa, Aa, Aa
Aa, Aa, Aa, Aa, Aa, Aa, Aa, Aa, Aa, Aa, Aa, Aa, Aa, Aa, Aa, Aa, Aa, Aa, Aa, Aa, Aa, Aa, Aa, Aa, Aa, Gd, Gd, Rp, Gd, Re, Aa, Aa, Aa, Aa, Aa, Aa, Aa, Aa, Aa, Aa, Aa, Aa, Aa, Aa, Aa, Aa, Aa, Aa, Aa, Aa, Aa, Aa, Aa, Aa, Aa
