Gll^Fmw, Gll^Fmw, Gll^Fmw, Gll^Fmw, Gll^Fmw, Gll^Fmw, Gd, Gd, Gll^Fmw, Gll^Fmw, Gll^Fmw, Gll^Fmw, Gll^Fmw, Gd, Gll, Gll, Wwf, Wwf, Ww, Ww, Xue, Xue, Xue, Xue
Gll^Fmw, Gll^Fmw, Gd, Gd, Gd, S6 Gd, Gll^Fmw, Gll^Fmw, Gll^Fmw, Gll^Fmw, Gll^Fmw, Gd, Gd, Gd, Gd, Gll, Gll, S7 Wwf, Wwf, Ww, Xue, 5 Xue^Kov, Xue, Xue
Gd, S5 Gd, Gd, Gll^Fmw, Gll^Fmw, Gll^Fmw, Gll^Fmw, Gll^Fmw, Gll^Fmw, Gll^Fmw, Gd, Gd, Gd, Gd, Gd, Gd, Gd, Gll, Wwf, Ww, Xue, R1 Xue^Cov, Xue, Xue
Gll^Fmw, Gll^Fmw, Gll^Fmw, Gd, Gd, Gll^Fmw, Gll^Fmw, Gll^Fmw, Gll^Fmw, Gll^Fmw, Gd, Gd, Gd, Gd, Gd, Gd, Gd, Gll, Wwf, Ww, Ww, Xue, Xue, Xue
Gll^Fmw, Gll^Fmw, Gd, Gd, Gll^Fmw, Gd, Gll^Fmw, Gll^Fmw, Gll^Fmw, Gll^Fmw, Gd, Gd, Gd, Gd, Gd, Gd, Gd, Gll, Gll, Wwf, Wwf, Ww, Ww, Xue
Gll^Fmw, Gll^Fmw, Gd, Gll^Fmw, Gll^Fmw, Gd, Gd, Gll^Fmw, Gd, Gd, Gd, Gd, Gd, Gd, Gd, Gd, Gd^Vhr, Gd, Gd, Gll, Wwf, Ww, Wwf, Wwf
Gd, Gd, Gd^Tf, Gll^Fmw, Gll^Fmw, Gll^Fmw, Gd^Vhr, Gd, Gd, Gd, Gd, Gd, Gd, Gd, Gd, Gd, Gd, Gd, Gll, Gll, Ww, Ww, Gll, Gll
Gd, Gd, Gll^Fmw, Gll^Fmw, Gd^Em, Gll^Fmw, Gd, Gd, Gd, Gd, Gll, Gd, Rp, Gll, Gll, Gll, Ss^Efm, Ss, Ss^Efm, Ww, Ss, Ss, Gll, Gll
Gll^Fdw, Gd, Gd, Gll^Fmw, Gll^Fmw, Gd, Gd, Gd, Gll, Gll, Ss^Efm, Gll, Rp, Gll, Ss, Ss^Efm, Ss^Ewf, Ss^Ewf, Ss^Efm, Ww, Ss^Ewf, Gll, Hhd^Es, Hhd
Gll^Fmw, Gll^Fmw, Gd^Em, Gd, Gd, Gd, Gd, Gd, Gll, Ss^Wkf, Khr, Chr, Rp, Chr, Khr, Ss^Tf, Ss, Ss^Ewl, Ww, Ww, Ss^Wkf, Gll, Mv, Md
Gll^Fmw, Gll^Fmw, Gd, Gd, Gd, Gd, Gd, Gll, Gll, Chr, Gll^Vct, Gd^Vct, Rp, Gd^Vhr, Rb^Vhhr, Chr, Gll, Ss^Ewl, Wwf, Ss^Wkf, Hhd, Md, Md, Md
Gd^Em, Gd, Gd, Gd, Gd, Gd, Gll, Chr, Re^Dc, Gll, Rb^Em, Re^Edt, 2 Khr, Re, Re^Dr, Re^Em, Rb^Dr, Chr, Wwf, Ss^Em, Hhd, Md, Md, Md
Hhd, S8 Gd, Gd, Gd, Gd, Gd, Gll, Rp^Dr, Khr, Rb, Ss^Efm, 1 Khr, 4 Khr, 3 Khr, Rb^Es, Rb, Khr, Chr, Wwf, Gll, Gd, Hhd^Es, Hhd, Md
Hhd, Hhd, Gd, Gd, Gd, Gd, Gd^Fmw, Gll^Fmw, Chr, Gll^Vhr, Gll^Dr, Ss^Efm, Rp, Gd^Efm, Rp^Vhcr, Re^Dc, Chr^Em, Wwf, Gll, Gll, Gd, Hhd, S9 Hhd^Es, Hhd
Ms, Hhd^Es, Hhd, Gd, Gd, Gd, Gd, Gll^Fmw, Gll, Chr, Rb^Dr, Rp^Vhcr, Rp^Es, Re^Vhr, Chr, Rb^Dr, Wwf, Wwf, Gll, Gd, Hhd, Hhd, Md, Mm
Ms, Ms, Ha^Vhha, Hhd^Esa, Gd, Gd, Gd, Gd, Gd, Gll, Gll, Chr, Rp, Chr, Ss, Ss^Tf, Wwf, Gll^Fmf, Gd, Gd, Hhd, Md, Ms, Ms
Ms^Fpa, Ha^Fpa, Ha, Ha, Aa, Gd, Gd, Gd, Gd, Gd, Rp, Rp, Rp, Rp, Wwf^Bw\r, Wwf, Gll, Gll, Gd^Esa, Gd, Ha, Ms^Fpa, Ms, Ms
Ha^Fpa, Ha, Aa, Aa, Aa, Aa, Aa, Gd^Esa, Rp, Rp, Gd, Gd, Gll, Gll, Wwf, Rp, Rp, Gd, Aa, Aa, Ha, Ha^Vla, Ha^Fma, Ha^Fma
Aa, Aa, Aa, Aa, Aa, Aa, Rra^Esa, Rra, Aa, Gd^Esa, Gll, Gd, Gll, Wwf, Gll, Gll, Aa, Rra, Rra^Esa, Aa, Aa, Ha^Fpa, Ha^Fpa, Ha^Fpa
Aa^Fpa, Aa, Aa, Aa, Rra, Rra, Aa, Aa, Wwf, Aa, Wwf, Gll, Wwf, Wwf^Esa, Wwf, Aa, Aa, Aa, Aa, Rra, Rra^Esa, Aa, Aa, Ha^Fpa
Aa^Fpa, Aa^Fpa, Rra, Rra^Esa, Aa, Aa, Wwf, Wwf, Aa, Wwf, Aa, Wwf, Aa, Aa, Aa, Wwf, Wwf, Aa, Aa, Aa^Ewsh, Aa, Rra, S4 Rra, Aa
Aa^Fpa, Aa^Fpa, Rra, Aa^Fpa, Aa^Fpa, Aa, Wwf, Aa, Aa, Aa, Aa, Aa, Aa, Aa, Ha, Aa, Aa, Wwf, Wwf, Wwf, Wwf, Wwf^Bw|r, Wwf, Rra
Aa^Fpa, Aa^Fpa, S3 Rra^Esa, Aa^Fpa, S1 Wwf, Wwf, Aa^Fpa, Aa^Ewsh, Ha^Fpa, Ha^Fpa, Ha^Fpa, Aa, Ha, Ha, Ms, Ms, Ms, Aa, Aa^Fpa, Aa^Fpa, Aa^Fpa, S2 Rra, Aa^Fpa, Wwf
Rra, Rra^Esa, Aa^Fpa, Aa^Fpa, Wwf, Aa^Fpa, Ha, Ha, Ha, Ha^Fpa, Ms, Ms, Ms, Ms, Ha, Ms, Ha, Aa^Fpa, Aa^Fpa, Aa^Fpa, Aa^Fpa, Rra^Esa, Aa^Fpa, Aa^Fpa
