Xv, Xv, Xv, Xv, Xv, Xv, Xv, Xv, Xv, Xv, Xv, Xv, Xv, Xv, Xv, Xv, Xv, Xv, Xv, Xv, Xv, Xv, Xv
Xv, Xv, Xv, Xv, Xv, Xv, Qxua^Xo, Qxua^Xo, Qxua^Xo, Qxua^Xo, Qxua^Xo, Qxua^Xo, Qxua^Xo, Qxua^Xo, Qxua^Xo, Qxua^Xo, Qxua^Xo, Xv, Xv, Xv, Xv, Xv, Xv
Xv, Xv, Xv, Xv, Qxua^Xo, Qxua^Xo, Wwf, Gs^Fp, Hh, Hh, Gg, Hh, Gs^Fp, Sm^Vhs, Rr, Rr, Gg, Qxua^Xo, Qxua^Xo, Xv, Xv, Xv, Xv
Xv, Xv, Qxua^Xo, Qxua^Xo, Gs^Fp, Sm^Vhs, Wwf, Wwf, Wwf, Gg, Gg^Ve, Gg, Gg, Gg, Rr, Ch, 3 Kh, Gg, Gg, Qxua^Xo, Qxua^Xo, Xv, Xv
Xv, Qxua^Xo, Mm, Hh, Wwf, Wwf, 2 Kh, Ch, Wwf, Gg, Gg, Gg, Mm, Gg, Rr, Ch, Gg, Gg, Gg, Hh, Hh, Qxua^Xo, Xv
Xv, Qxua^Xo, Gs^Fp, Hh, Wwf, Gg, Wwf, Ch, Wwf, Gg, Gs^Fp, Hh, Gg, Gg, Gg, Rr, Gs^Fp, Gg, Gg^Vh, Gg, Gs^Fp, Qxua^Xo, Xv
Qxua^Xo, Qxua^Xo, Wwf, Wwf, Chw, Wwf, Gs^Fp, Wwf, Rr, Uu^Vu, Xu, Gs^Fp, Xu, Uu^Vud, Rr, Rr, Rr, Gg, Gg, Gg, Gg, Qxua^Xo, Xv
Qxua^Xo, Wwf, Sm^Vhs, Wwf, Wwf, Gs, Ds, Sm, Tb^Tf, Ias, Cud, Xu, Rb, Ias, Uu, Cud, Wwf, Gs, Gs^Fp, Hh, Gs, Qxua^Xo, Xv
Qxua^Xo, Wwf, Wwf, Ww, Chw, Wwf, Mm, Xu, Xu, Uu, Ias, Rb, Ias, Ur^Fp, Tb^Tf, Xu, Mm, Wwf, Chw, Wwf, Wwf, Qxua^Xo, Qxua^Xo
Xv, Qxua^Xo, Gs, Chw, Wwf, Wwf, Wwf, Sm, Rr, Ur^Fp, Rb, Ias, Rb, Uh, Xu, Xu, Ds, Wwf, Wwf, Ww, Sm^Vhs, Wwf, Qxua^Xo
Xv, Qxua^Xo, Gg, Gs^Fp, Hh, Gs, Gs^Fp, Rr, Uu^Vud, Ias, Uh, Cud, Rb, Ias, Xu, Sm, Wwf, Chw, Gs, Wwf, Wwf, Wwf, Qxua^Xo
Xv, Qxua^Xo, Gg, Gg^Ve, Gg, Gg, Rr, Rr, Gg, Xu, Xu, Xu, Uu^Vu, Rr, Rr, Rr, Wwf, Gg, Gg, Gs^Fp, Wwf, Qxua^Xo, Xv
Xv, Qxua^Xo, Hh, Gg, Gg, Gg, Rr, Gg, Gg, Gs^Fp, Hh, Hh, Gg, Gg, Hh, Wwf, 1 Kh, Gg, Wwf, Wwf, Hh, Qxua^Xo, Xv
Xv, Qxua^Xo, Gs^Fp, Gg, Ch, 4 Kh, Rr, Gg^Vh, Gg, Gg, Gg, Gs^Fp, Gg, Gg, Gg, Wwf, Ch, Ch, Wwf, Hh, Mm, Qxua^Xo, Xv
Xv, Qxua^Xo, Qxua^Xo, Gg, Gg, Ch, Gg, Rr, Hh, Hh, Gg, Gg, Gg^Ve, Gg, Gg, Wwf, Wwf, Wwf, Sm^Vhs, Gs^Fp, Qxua^Xo, Qxua^Xo, Xv
Xv, Xv, Xv, Qxua^Xo, Qxua^Xo, Gg, Rr, Rr, Gs^Fp, Mm, Hh, Gg, Gg, Gg, Ss, Gg, Hh, Wwf, Qxua^Xo, Qxua^Xo, Xv, Xv, Xv
Xv, Xv, Xv, Xv, Xv, Qxua^Xo, Qxua^Xo, Hh, Qxua^Xo, Gs^Fp, Qxua^Xo, Gg, Qxua^Xo, Gs^Fp, Qxua^Xo, Gs^Fp, Qxua^Xo, Qxua^Xo, Xv, Xv, Xv, Xv, Xv
Xv, Xv, Xv, Xv, Xv, Xv, Xv, Qxua^Xo, Xv, Qxua^Xo, Xv, Qxua^Xo, Xv, Qxua^Xo, Xv, Qxua^Xo, Xv, Xv, Xv, Xv, Xv, Xv, Xv
Xv, Xv, Xv, Xv, Xv, Xv, Xv, Xv, Xv, Xv, Xv, Xv, Xv, Xv, Xv, Xv, Xv, Xv, Xv, Xv, Xv, Xv, Xv
