Xu, Xu, Xu, Xu, Xu, Xu, Xu, Xu, Xu, Xu, Xu, Xu, Xu, Xu, Xu, Xu, Xu, Xu, Xu, Xu, Xu, Xu, Xu, Xu, Xu, Xu, Xu, Xu, Xu, Xu, Xu, Xu, Xu, Xu, Xu, Xu, Xu, Xu, Xu, Xu, Xu, Xu, Xu, Xu, Xu, Xu, Xu, Xu, Xu
Xu, Xu, Xu, Xu, Xu, Xu, Xu, Xu, Xu, Xu, Xu, Xu, Xu, Xu, Xu, Xu, Xu, Xu, Xu, Xu, Xu, Xu, Xu, Xu, Xu, Xu, Xu, Xu, Xu, Xu, Xu, Xu, Xu, Xu, Xu, Xu, Xu, Xu, Xu, Xu, Xu, Xu, Xu, Xu, Xu, Xu, Xu, Xu, Xu
Xu, Xu, Xu, Xu, Xu, Xu, Xu, Xu, Xu, Xu, Xu, Xu, Wog, Wwg, Qxu, Qlf, Qlf, Xuc, Xuc, Xu, Xu, Xu, Ur^Vhc, Xu, Qxu, Rr, Uu, Xuc, Xuc, Xu, Ss, Xu, Uu, Xu, Xu, Xu, Xu, Xu, Xu, Xu, Xu, Xu, Xu, Xu, Xu, Xu, Xu, Xu, Xu
Xu, Xu, Xu, Xu, Wwf, Xu, Xu, Xu, Xu, Xu, Xu, Wwg, Wwg, Wwg, Qxu^Bh/, Uh, Qlf, Xuc, Wwf, Rp, Rp, Hhd^Fdf, Rp, Uu, Uu, Qxu^Bp/, Qxu, Xuc, Rp, Rp^Vhcr, Ss^Bh/, Qxu^Bh/, Qxu, Rr, Xu, Xu, Xu, Xu, Xu, Xu, Xu, Xu, Xu, Xu, Wwf, Xu, Xu, Xu, Xu
Xu, Xu, Wwf, Wwf, Ur, Wwf, Wwf, Rp^Ebn, Rp^Vud, Xu, Xu, Rp, Rp, Wwf, Hhd^Fmf, Qxu, Xuc, Xuc, Wwf, Chr, Rp, Rp, Hhd^Fdf, Rp, Ur, Ss, Xuc, Xuc, Rp, Wwf, Rp, Qxu, Qxu, Qxu, Wwf, Wwf, Wwf, Xu, Xu, Xu, Rp^Vud, Rp^Ebn, Wwf, Wwf, Ur, Wwf, Wwf, Xu, Xu
Xu, Xu, Cf, Cf, Cf, Ur, Wwf, Re, Rp, Xu, Xu, Ias^Vhcr, Rp, Wwf, Rp, Cer, Ker, Xuc, Wwf, Rp, Re^Tf, Re, Xuc, Rp, Ur, Chs, Uu^Tf, Rp, Hhd^Fdf, Wwf, Rp, Kdr, Cdr, Wwf, Rp, Rp, Rp, Wwf, Xu, Xu, Rp, Re, Wwf, Ur, Cf, Cf, Cf, Xu, Xu
Xu, Xu, Cf, 1 Kfr, Cf, Ur, Wwf, Re, Re, Chr, Wwf, Rp, Wwf, Wwf, Wwf, Hhd^Fmf, Rp, Rp, Wwf, Rp, Rp, Rp, Xuc, Rp, Rp, Ur, Rp, Rp, Wwf, Wwf, Wwf, Ds, Wwf, Wwf, Ur, Ias^Vhcr, Rp, Wwf, Wwf, Chr, Re, Re, Wwf, Ur, Cf, 4 Kfr, Cf, Xu, Xu
Xu, Xu, Wwf, Cf, Xuc, Xuc, Xuc, Wwf, Wwf, Wwf, Rp, Wwf, Rp, Ds, Ds, Wwf, Wwf, Wwf, Hhd^Fmf, Wwf, Wwf, Wwf, Gll^Feth, Xuc, Rp, Ur, Rp, Wwf, Xuc, Rp, Rp, Wwf, Uu, Hhd^Fmf, Ur, Rp, Uu, Rp, Rp, Wwf, Wwf, Wwf, Xuc, Xuc, Wwf, Cf, Xu, Xu, Xu
Xu, Xu, Wwf, Ias, Chr^Ebn, Xuc, Xuc, Ur, Wwf, Rp, Ur, Rp, Xuc, Rp, Rp, Rp, Wwf, Gll^Vhcr, Xuc, Rp, Wwf, Rp, Rp, Hhd, Ur, Rp, Wwf, Wwf, Xuc, Chr, Rp, Wwf, Hhd^Fmf, Sm, Rp, Rp, Xuc, Cer, Rp, Wwf, Ur, Ur, Xuc, Xuc, Wwf, Ias, Ias, Xu, Xu
Xu, Xu, Wwf, Ias^Vu, Ias, Xuc, Xuc, Xuc, Wwf, Rp, Wwf, Xuc, Xuc, Xuc, Wwf, Wwf, Wwf, Rp, Rp, Hhd^Fmf, Ds, Wwf, Rp, Ur, Uu, Wwf, Rp, Rp, Rp, Xuc, Wwf, Wwf, Wwf, Wwf, Wwf, Xuc, Xuc, Xuc, Wwf, Wwf, Ur, Xuc, Xuc, Ias, Wwf, Chr^Ebn, Ias, Xu, Xu
Xu, Xu, Xu, Wwf, Uu, Ur, Xuc, Xuc, Rp, Wwf, Ds, Wwf, Wwf, Wwf, Ias, Hhd^Fmf, Uu^Tf, Wwf, Uu, Rp, Ds, Wwf, Rp, Uu^Tf, Wwg, Wwf, Rp, Ias^Vhcr, Rp, Wwf, Rp, Ds^Dc, Rp, Rp, Rp, Wwf, Rp, Rp, Wwf, Ur, Rp, Xuc, Xuc, Ias^Vu, Ias, Wwf, Xu, Xu, Xu
Xu, Xu, Xu, Wwf, Ur, Ur, Xuc, Rp, Cte, Rp, Ss, Ds, Wwf, Rp, Rp, Chr, Ias, Wwf, Wwf, Rp, Wwg^Bw\, Wwf, Wwf, Ss^Bw\r, Wog^Bw\r, Wwf, Wwf, Rp, Wwg^Bw\, Wwf, Wwf, Rp, Ias, Hhd^Fmf, Rp, Wwf, Wwf, Wwf, Ss, Rp, Cte, Rp, Xuc, Xuc, Ur, Wwf, Xu, Xu, Xu
Xu, Xu, Xu, Wwf, Ias, Xuc, Xuc, Rp, Rp, Rp, Wwf, Wwf, Rp, Wwf, Rp, Hhd^Fmf, Rp, Rp, Rp, Wwf, Rp, Rp, Rp, Wwf, Wwg, Ss^Bw\r, Rp, Wwf, Ds, Rp, Uu, Wwf, Uu^Tf, Chr, Ias, Rp, Wwf, Ds, Ds, Rp, Rp, Rp, Xuc, Ur, Uu, Wwf, Xu, Xu, Xu
Xu, Xu, Ias, Wwf, Wwf, Ias^Vu, Xuc, Xuc, Ur, Ur, Wwf, Rp, Xuc, Wwf, Wwf, Rp, Wwf, Ds^Dc, Wwf, Wwf, Rp, Ias^Vhcr, Rp, Wwf, Uu, Uu^Tf, Rp, Wwf, Ds, Rp, Rp, Wwf, Wwf, Hhd^Fmf, Wwf, Wwf, Xuc, Wwf, Wwf, Wwf, Wwf, Xuc, Xuc, Ur, Ias, Wwf, Wwf, Xu, Xu
Xu, Xu, Ias, Chr^Ebn, Wwf, Ias, Xuc, Xuc, Ur, Wwf, Rp, Xuc, Xuc, Xuc, Rp, Wwf, Hhd^Fmf, Wwf, Rp, Xuc, Xuc, Rp, Wwf, Wwf, Ur, Ur, Rp, Wwf, Wwf, Hhd^Fmf, Xuc, Rp, Wwf, Wwf, Rp, Xuc, Xuc, Xuc, Ur, Rp, Wwf, Xuc, Xuc, Xuc, Chr^Ebn, Ias^Vu, Wwf, Xu, Xu
Xu, Xu, Xu, Ias, Wwf, Xuc, Xuc, Ur, Wwf, Wwf, Rp, Cer, Uu, Rp, Ur, Sm, Uu, Wwf, Rp, Chr, Xuc, Wwf, Rp, Rp, Rp, Hhd, Gll^Feth, Rp, Wwf, Rp, Hhd^Fmf, Ias^Vhcr, Wwf, Rp, Ds, Rp, Rp, Rp, Rp, Rp, Wwf, Ur, Xuc, Xuc, Xuc, Ias, Wwf, Xu, Xu
Xu, Xu, Cf, Cf, Cf, Xuc, Wwf, Wwf, Re, Wwf, Wwf, Rp, Rp, Rp, Ur, Hhd^Fmf, Wwf, Wwf, Wwf, Rp, Wwf, Wwf, Rp, Ur, Rp, Xuc, Xuc, Wwf, Rp, Wwf, Wwf, Wwf, Rp, Wwf, Wwf, Ds, Wwf, Wwf, Wwf, Wwf, Re, Wwf, Wwf, Xuc, Cf, Cf, Cf, Xu, Xu
Xu, Xu, Cf, 3 Kfr, Cf, Ur, Wwf, Re, Rp, Chr, Xu, Wwf, Rp, Ias^Vhcr, Rp, Wwf, Cdr, Ds, Rp, Wwf, Hhd^Fdf, Rp, Uu^Tf, Ur, Ur, Rp, Xuc, Rp, Re^Tf, Rp, Wwf, Rp, Ker, Hhd^Fmf, Rp, Wwf, Rp, Rp, Xu, Chr, Rp, Re, Wwf, Ur, Cf, 2 Kfr, Cf, Xu, Xu
Xu, Xu, Wwf, Cf, Ur, Ur, Wwf, Re, Rp^Vud, Xu, Xu, Wwf, Wwf, Rp, Wwf, Wwf, Qxu, Kdr, Rp, Wwf, Rp, Rp, Xuc, Chs, Ur, Rp, Hhd^Fdf, Re, Rp, Rp, Wwf, Xuc, Xuc, Cer, Hhd^Fmf, Wwf, Rp, Ias^Vhcr, Xu, Xu, Rp^Vud, Re, Wwf, Ur, Ur, Cf, Wwf, Xu, Xu
Xu, Xu, Xu, Wwf, Wwf, Wwf, Xu, Rp^Ebn, Xu, Xu, Xu, Xu, Xu, Wwf, Xu, Qxu, Qxu, Qxu, Ss^Bh/, Wwf, Rp, Xuc, Qxu, Ss, Uu, Rp, Rp, Rp, Rp, Chr, Wwf, Xuc, Qlf, Qxu, Qxu^Bh/, Wwf, Wwg, Rp, Xu, Xu, Xu, Rp^Ebn, Xu, Wwf, Wwf, Wwf, Xu, Xu, Xu
Xu, Xu, Xu, Xu, Xu, Xu, Xu, Xu, Xu, Xu, Xu, Xu, Xu, Xu, Xu, Rr, Uu, Qxu^Bh/, Ss, Rp^Vhcr, Xuc, Xuc, Uu, Qxu^Bp/, Qxu, Uu, Ur^Vhc, Hhd^Fdf, Xu, Rp, Xuc, Xuc, Qlf, Uh, Qxu, Wwg, Wog, Wwg, Xu, Xu, Xu, Xu, Xu, Xu, Xu, Xu, Xu, Xu, Xu
Xu, Xu, Xu, Xu, Xu, Xu, Xu, Xu, Xu, Xu, Xu, Xu, Xu, Xu, Xu, Xu, Xu, Xu, Xu, Xu, Xu, Xuc, Xu, Rr, Xu, Xu, Xu, Xu, Xu, Xu, Xu, Xuc, Xu, Qlf, Xu, Wwg, Xu, Xu, Xu, Xu, Xu, Xu, Xu, Xu, Xu, Xu, Xu, Xu, Xu
Xu, Xu, Xu, Xu, Xu, Xu, Xu, Xu, Xu, Xu, Xu, Xu, Xu, Xu, Xu, Xu, Xu, Xu, Xu, Xu, Xu, Xu, Xu, Xu, Xu, Xu, Xu, Xu, Xu, Xu, Xu, Xu, Xu, Xu, Xu, Xu, Xu, Xu, Xu, Xu, Xu, Xu, Xu, Xu, Xu, Xu, Xu, Xu, Xu
