Xu, Xu, Xu, Xu, Xu, Xu, Xu, Xu, Xu, Xu, Xu, Xu, Xu, Xu, Xu, Xu, Xu, Xu, Xu, Xu, Xu, Xu, Xu, Xu, Xu, Xu, Xu, Xu, Xu, Xu, Xu, Xu, Xu, Xu, Xu, Xu, Xu, Xu, Xu, Xu, Xu, Xu, Xu, Xu, Xu, Xu, Xu, Xu, Xu
Xu, Xu, Xu, Xu, Xu, Xu, Xu, Xu, Xu, Xu, Xu, Xu, Xu, Xu, Xu, Xu, Xu, Xu, Xu, Xu, Xu, Xu, Xu, Xu, Xu, Xu, Xu, Xu, Xu, Xu, Xu, Xu, Xu, Xu, Xu, Xu, Xu, Xu, Xu, Xu, Xu, Xu, Xu, Xu, Xu, Xu, Xu, Xu, Xu
Xu, Xu, Xu, Xu, Xu, Xu, Xu, Xu, Xu, Xu, Xu, Xu, Wog, Wwg, Qxu, Qlf, Qlf, Xuc, Xuc, Xu, Xu, Xu, Ur^Vhc, Xu, Qxu, Rr, Uu, Xuc, Xuc, Xu, Ss, Xu, Uu, Xu, Xu, Xu, Xu, Xu, Xu, Xu, Xu, Xu, Xu, Xu, Xu, Xu, Xu, Xu, Xu
Xu, Xu, Xu, Xu, Wwf, Xu, Xu, Xu, Xu, Xu, Xu, Wwg, Wwg, Wwg, Qxu^Bh/, Uh, Qlf, Xuc, Wwf, Rp^Esd, Rp^Esd, Gll^Fmf, Rp^Edt, Uu, Uu, Qxu^Bp/, Qxu, Xuc, Rp^Es, Rp^Vhcr, Ss^Bh/, Qxu^Bh/, Qxu, Rr, Xu, Xu, Xu, Xu, Xu, Xu, Xu, Xu, Xu, Xu, Wwf, Xu, Xu, Xu, Xu
Xu, Xu, Wwf, Wwf, Ur, Wwf, Wwf, Rp^Ebn, Rp^Vud, Xu, Xu, Rp, Rp, Wwf, Gll^Fmf, Qxu, Xuc^Efs, Xuc, Wwf, Chr, Rp, Rp, Hhd, Rp, Ur^Es, Ss, Xuc^Efs, Xuc, Rp, Wwf, Rp, Qxu, Qxu, Qxu, Wwf, Wwf, Wwf, Xu, Xu, Xu, Rp^Vud, Rp^Ebn, Wwf, Wwf, Ur, Wwf, Wwf, Xu, Xu
Xu, Xu, Cfr^Edt, Cfr, Cfr, Ur^Esd, Wwf, Re^Es, Rp^Esd, Xu, Xu, Ias^Vhcr, Rp^Edt, Wwf, Rp^Es, Cer, Ker, Xuc, Wwf, Rp^Esd, Re^Tf, Re, Xuc, Rp, Ur^Edt, Chs, Uu^Tf, Rp^Edt, Hhd^Fdf, Wwf, Rp, Kdr, Cdr, Wwf, Rp, Rp^Es, Rp^Esd, Wwf, Xu, Xu, Rp^Esd, Re, Wwf, Ur^Edb, Cfr^Edt, Cfr, Cfr, Xu, Xu
Xu, Xu, Cfr, 1 Kfr, Cfr^Edb, Ur^Edb, Wwf, Re, Re^Es, Chr, Wwf, Rp, Wwf, Wwf, Wwf, Hhd, Rp^Edt, Rp^Esd, Wwf, Rp^Es, Rp^Es, Rp, Xuc, Rp^Es, Rp, Ur^Es, Rp^Edt, Rp^Edt, Wwf, Wwf, Wwf, Ds, Wwf, Wwf, Ur^Es, Ias^Vhcr, Rp, Wwf, Wwf, Chr, Re^Em, Re^Es, Wwf, Ur^Es, Cfr^Edt, 4 Kfr, Cfr^Edb, Xu, Xu
Xu, Xu, Wwf, Cfr^Edb, Xuc, Xuc, Xuc, Wwf, Wwf, Wwf, Rp, Wwf, Rp^Edt, Ds, Ds, Wwf, Wwf, Wwf, Gll^Fmf, Wwf, Wwf, Wwf, Gll^Feth, Xuc^Efs, Rp, Ur^Edt, Rp, Wwf, Xuc, Rp, Rp, Wwf, Uu^Em, Gll^Fmf, Ur^Esd, Rp, Uu, Rp^Edt, Rp, Wwf, Wwf, Wwf, Xuc, Xuc, Wwf, Cfr^Edt, Xu, Xu, Xu
Xu, Xu, Wwf, Ias, Chr^Ebn, Xuc, Xuc, Ur, Wwf, Rp, Ur, Rp^Es, Xuc, Rp^Edt, Rp, Rp^Esd, Wwf, Gll^Vhcr, Xuc^Efs, Rp, Wwf, Rp, Rp^Edt, Hhd, Ur^Em, Rp^Esd, Wwf, Wwf, Xuc, Chr, Rp, Wwf, Hhd, Sm, Rp, Rp, Xuc, Cer, Rp^Es, Wwf, Ur, Ur, Xuc, Xuc, Wwf, Ias, Ias, Xu, Xu
Xu, Xu, Wwf, Ias^Vu, Ias, Xuc, Xuc, Xuc, Wwf, Rp^Edt, Wwf, Xuc, Xuc, Xuc, Wwf, Wwf, Wwf, Rp, Rp, Hhd, Ds, Wwf, Rp, Ur^Em, Uu, Wwf, Rp^Es, Rp, Rp, Xuc, Wwf, Wwf, Wwf, Wwf, Wwf, Xuc, Xuc, Xuc, Wwf, Wwf, Ur, Xuc, Xuc, Ias, Wwf, Chr^Ebn, Ias, Xu, Xu
Xu, Xu, Xu, Wwf, Uu, Ur^Edt, Xuc, Xuc, Rp, Wwf, Ds, Wwf, Wwf, Wwf, Ias, Hhd, Uu^Tf, Wwf, Uu, Rp^Edt, Ds, Wwf, Rp^Edt, Uu^Tf, Wwg, Wwf, Rp, Ias^Vhcr, Rp, Wwf, Rp^Es, Ds^Dc, Rp^Es, Rp, Rp, Wwf, Rp^Edt, Rp^Edt, Wwf, Ur^Esd, Rp, Xuc, Xuc, Ias^Vu, Ias, Wwf, Xu, Xu, Xu
Xu, Xu, Xu, Wwf, Ur, Ur^Esd, Xuc, Rp, Cte, Rp^Edt, Ss, Ds, Wwf, Rp, Rp, Chr, Ias, Wwf, Wwf, Rp^Edt, Wwg^Bw\, Wwf, Wwf, Ss^Bw\r, Wog^Bw\r, Wwf, Wwf, Rp, Wwg^Bw\, Wwf, Wwf, Rp, Ias, Gll^Fmf, Rp, Wwf, Wwf, Wwf, Ss, Rp, Cte, Rp, Xuc, Xuc, Ur^Esd, Wwf, Xu, Xu, Xu
Xu, Xu, Xu, Wwf, Ias, Xuc, Xuc, Rp, Rp^Es, Rp^Es, Wwf, Wwf, Rp, Wwf, Rp^Edt, Gll^Fmf, Rp, Rp^Es, Rp, Wwf, Rp^Esd, Rp, Rp^Es, Wwf, Wwg, Ss^Bw\r, Rp^Edt, Wwf, Ds, Rp^Esd, Uu, Wwf, Uu^Tf, Chr, Ias, Rp, Wwf, Ds, Ds, Rp^Esd, Rp, Rp^Edt, Xuc, Ur, Uu, Wwf, Xu, Xu, Xu
Xu, Xu, Ias, Wwf, Wwf, Ias^Vu, Xuc, Xuc, Ur, Ur, Wwf, Rp, Xuc, Wwf, Wwf, Rp^Es, Wwf, Ds^Dc, Wwf, Wwf, Rp, Ias^Vhcr, Rp^Edt, Wwf, Uu^Em, Uu^Tf, Rp^Es, Wwf, Ds, Rp, Rp^Edt, Wwf, Wwf, Hhd, Wwf, Wwf, Xuc, Wwf, Wwf, Wwf, Wwf, Xuc, Xuc, Ur, Ias, Wwf, Wwf, Xu, Xu
Xu, Xu, Ias, Chr^Ebn, Wwf, Ias, Xuc, Xuc, Ur^Es, Wwf, Rp, Xuc, Xuc, Xuc, Rp, Wwf, Hhd, Wwf, Rp, Xuc, Xuc, Rp^Es, Wwf, Wwf, Ur^Em, Ur^Em, Rp, Wwf, Wwf, Hhd, Xuc^Efs, Rp, Wwf, Wwf, Rp, Xuc, Xuc, Xuc, Ur, Rp, Wwf, Xuc, Xuc, Xuc, Chr^Ebn, Ias^Vu, Wwf, Xu, Xu
Xu, Xu, Xu, Ias, Wwf, Xuc, Xuc, Ur^Edb, Wwf, Wwf, Rp, Cer, Uu, Rp, Ur^Edt, Sm, Uu^Es, Wwf, Rp, Chr, Xuc, Wwf, Rp, Rp, Rp^Es, Hhd, Gll^Feth, Rp^Es, Wwf, Rp^Edt, Gll^Fmf, Ias^Vhcr, Wwf, Rp^Edt, Ds, Rp^Es, Rp^Edt, Rp, Rp, Rp^Esd, Wwf, Ur, Xuc, Xuc, Xuc, Ias, Wwf, Xu, Xu
Xu, Xu, Cfr^Edb, Cfr, Cfr, Xuc, Wwf, Wwf, Re^Em, Wwf, Wwf, Rp, Rp^Edt, Rp^Esd, Ur^Edt, Gll^Fmf, Wwf, Wwf, Wwf, Rp^Es, Wwf, Wwf, Rp, Ur^Edt, Rp, Xuc^Efs, Xuc, Wwf, Rp^Es, Wwf, Wwf, Wwf, Rp, Wwf, Wwf, Ds, Wwf, Wwf, Wwf, Wwf, Re, Wwf, Wwf, Xuc, Cfr, Cfr^Edt, Cfr, Xu, Xu
Xu, Xu, Cfr^Edb, 3 Kfr, Cfr^Edb, Ur^Esd, Wwf, Re, Rp, Chr, Xu, Wwf, Rp, Ias^Vhcr, Rp^Esd, Wwf, Cdr, Ds, Rp, Wwf, Hhd^Fdf, Rp, Uu^Tf, Ur^Edt, Ur, Rp, Xuc, Rp^Edt, Re^Tf, Rp, Wwf, Rp, Ker, Hhd, Rp^Edt, Wwf, Rp^Edt, Rp^Es, Xu, Chr, Rp^Esd, Re^Em, Wwf, Ur, Cfr, 2 Kfr, Cfr, Xu, Xu
Xu, Xu, Wwf, Cfr, Ur, Ur, Wwf, Re^Em, Rp^Vud, Xu, Xu, Wwf, Wwf, Rp, Wwf, Wwf, Qxu, Kdr, Rp^Edt, Wwf, Rp, Rp^Edt, Xuc^Efs, Chs, Ur, Rp, Hhd, Re, Rp^Es, Rp^Es, Wwf, Xuc, Xuc^Efs, Cer, Gll^Fmf, Wwf, Rp^Es, Ias^Vhcr, Xu, Xu, Rp^Vud, Re^Es, Wwf, Ur, Ur, Cfr^Edt, Wwf, Xu, Xu
Xu, Xu, Xu, Wwf, Wwf, Wwf, Xu, Rp^Ebn, Xu, Xu, Xu, Xu, Xu, Wwf, Xu, Qxu, Qxu, Qxu, Ss^Bh/, Wwf, Rp^Edt, Xuc, Qxu, Ss, Uu, Rp, Rp, Rp, Rp^Esd, Chr, Wwf, Xuc, Qlf, Qxu, Qxu^Bh/, Wwf, Wwg, Rp^Edt, Xu, Xu, Xu, Rp^Ebn, Xu, Wwf, Wwf, Wwf, Xu, Xu, Xu
Xu, Xu, Xu, Xu, Xu, Xu, Xu, Xu, Xu, Xu, Xu, Xu, Xu, Xu, Xu, Rr, Uu, Qxu^Bh/, Ss, Rp^Vhcr, Xuc, Xuc, Uu, Qxu^Bp/, Qxu, Uu, Ur^Vhc, Gll^Fmf, Xu, Rp, Xuc, Xuc, Qlf, Uh, Qxu, Wwg, Wog, Wwg, Xu, Xu, Xu, Xu, Xu, Xu, Xu, Xu, Xu, Xu, Xu
Xu, Xu, Xu, Xu, Xu, Xu, Xu, Xu, Xu, Xu, Xu, Xu, Xu, Xu, Xu, Xu, Xu, Xu, Xu, Xu, Xu, Xuc, Xu, Rr, Xu, Xu, Xu, Xu, Xu, Xu, Xu, Xuc, Xu, Qlf, Xu, Wwg, Xu, Xu, Xu, Xu, Xu, Xu, Xu, Xu, Xu, Xu, Xu, Xu, Xu
Xu, Xu, Xu, Xu, Xu, Xu, Xu, Xu, Xu, Xu, Xu, Xu, Xu, Xu, Xu, Xu, Xu, Xu, Xu, Xu, Xu, Xu, Xu, Xu, Xu, Xu, Xu, Xu, Xu, Xu, Xu, Xu, Xu, Xu, Xu, Xu, Xu, Xu, Xu, Xu, Xu, Xu, Xu, Xu, Xu, Xu, Xu, Xu, Xu
