Xu, Xu, Xu, Xu, Xu, Xu, Xu, Xu, Xu, Xu, Xu, Xu, Xu, Xu, Xu, Xu, Xu, Xu, Xu, Xu, Xu, Xu, Xu, Xu, Xu, Xu, Xu, Xu, Xu, Xu, Xu, Xu, Xu, Xu, Xu, Xu, Xu, Xu, Xu, Xu, Xu
Xu, Xu, Xu, Xu, Xu, Xu, Xu, Xu, Xu, Xu, Xu, Xu, Xu, Xu, Xu, Xu, Xu, Xu, Xu, Xu, Xu, Xu, Xu, Xu, Xu, Xu, Xu, Xu, Xu, Xu, Xu, Xu, Xu, Xu, Xu, Xu, Xu, Xu, Xu, Xu, Xu
Xu, Xu, Xu, Xu, Xu, Xu, Xu, Xu, Wog, Wwg, Qxu, Qxu, Qxu, Xuc, Xuc, Xu, Xu, Xu, Ur^Vhc, Xu, Qxu, Qxu, Qxu, Xuc, Xuc, Xu, Ss, Xu, Qxu, Xu, Xu, Xu, Xu, Xu, Xu, Xu, Xu, Xu, Xu, Xu, Xu
Xu, Xu, Wwg, Wwg, Xu, Xu, Xu, Wwg, Wwg, Wwg, Qxu, Qxu, Qxu, Xuc, Wwf, Rp, Rp, Hhd^Fdf, Rp, Uu, Uu, Qxu, Qxu, Xuc, Rp, Rp^Vhcr, Ss, Qxu, Qxu, Qxu, Xu, Xu, Xu, Xu, Xu, Xu, Xu, Wwg, Wwg, Xu, Xu
Xu, Xu, Wwg, Urb^Ebn, Urb^Vud, Xu, Xu, Rp, Rp, Wwf, Hhd^Fmf, Qxu, Xuc, Xuc, Wwf, Chr, Rp, Rp, Hhd^Fdf, Rp, Ur, Ss, Xuc, Xuc, Rp, Wwf, Rp, Qxu, Qxu, Qxu, Wwf, Wwf, Wwf, Xu, Xu, Xu, Urb^Vud, Urb^Ebn, Wwg, Xu, Xu
Xu, Xu, Chw, Cud, Cud, Xu, Xu, Ias^Vhcr, Rp, Wwf, Rp, Cer, Ker, Xuc, Wwf, Rp, Re^Tf, Re, Xuc, Rp, Ur, Chs, Uu^Tf, Rp, Hhd^Fdf, Wwf, Rp, Kdr, Cdr, Wwf, Rp, Rp, Rp, Wwf, Xu, Xu, Cud, Cud, Chw, Xu, Xu
Xu, Xu, Chw, 1 Kud, Cud, Xu, Wwf, Rp, Wwf, Wwf, Wwf, Hhd^Fmf, Rp, Rp, Wwf, Rp, Rp, Rp, Xuc, Rp, Rp, Ur, Rp, Rp, Wwf, Wwf, Wwf, Ds, Wwf, Wwf, Ur, Ias^Vhcr, Rp, Wwf, Wwf, Xu, Cud, 4 Kud, Chw, Xu, Xu
Xu, Xu, Xu, Chw, Wwf, Wwf, Rp, Wwf, Rp, Ds, Ds, Wwf, Wwf, Wwf, Hhd^Fmf, Wwf, Wwf, Wwf, Gll^Feth, Xuc, Rp, Ur, Rp, Wwf, Xuc, Qxu, Qxu, Wwf, Uu, Hhd^Fmf, Ur, Rp, Uu, Rp, Rp, Wwf, Wwf, Chw, Xu, Xu, Xu
Xu, Xu, Xu, Ur, Wwf, Rp, Ur, Rp, Xuc, Rp, Rp, Rp, Wwf, Gll^Vhcr, Xuc, Rp, Wwf, Rp, Rp, Hhd, Ur, Rp, Wwf, Wwf, Xuc, Qxu, Qxu, Wwf, Hhd^Fmf, Sm, Rp, Rp, Xuc, Cer, Rp, Wwf, Ur, Ur, Xu, Xu, Xu
Xu, Xu, Xu, Xu, Wwf, Rp, Wwf, Xuc, Xuc, Xuc, Wwf, Wwf, Wwf, Rp, Xuc, Hhd^Fmf, Ds, Wwf, Rp, Ur, Uu, Wwf, Rp, Rp, Rp, Xuc, Wwf, Wwf, Wwf, Wwf, Wwf, Xuc, Xuc, Xuc, Wwf, Wwf, Ur, Xu, Xu, Xu, Xu
Xu, Xu, Xu, Xu, Rp, Wwf, Ds, Wwf, Wwf, Wwf, Gll^Fmf, Hhd, Uu^Tf, Wwf, Xuc, Rp, Ds, Wwf, Rp, Uu^Tf, Wwg, Wwf, Rp, Ias^Vhcr, Rp, Wwf, Rp, Ds^Dc, Rp, Rp, Rp, Wwf, Rp, Rp, Wwf, Ur, Rp, Xu, Xu, Xu, Xu
Xu, Xu, Xu, Rp, Cte, Rp, Ss, Ds, Wwf, Rp, Rp, Chr, Gll^Fmf, Wwf, Wwf, Rp, Chr, Wwf, Wwf, Ss^Bw\r, Wog^Bw\r, Wwf, Wwf, Rp, Chr, Wwf, Wwf, Rp, Gll^Fmf, Hhd, Rp, Wwf, Wwf, Wwf, Ss, Rp, Cte, Rp, Xu, Xu, Xu
Xu, Xu, Xu, Rp, Rp, Rp, Wwf, Wwf, Rp, Wwf, Rp, Hhd, Rp, Rp, Rp, Wwf, Rp, Rp, Rp, Wwf, Wwg, Ss^Bw\r, Rp, Wwf, Ds, Rp, Xuc, Wwf, Uu^Tf, Chr, Gll^Fmf, Rp, Wwf, Ds, Ds, Rp, Rp, Rp, Xu, Xu, Xu
Xu, Xu, Xu, Xu, Ur, Ur, Wwf, Rp, Xuc, Wwf, Wwf, Rp, Wwf, Ds^Dc, Wwf, Wwf, Rp, Ias^Vhcr, Rp, Wwf, Uu, Uu^Tf, Rp, Wwf, Ds, Rp, Xuc, Wwf, Wwf, Hhd, Wwf, Wwf, Xuc, Wwf, Wwf, Wwf, Wwf, Xu, Xu, Xu, Xu
Xu, Xu, Xu, Xu, Ur, Wwf, Rp, Xuc, Xuc, Xuc, Rp, Wwf, Hhd^Fmf, Wwf, Qxu, Xuc, Xuc, Rp, Wwf, Wwf, Ur, Ur, Rp, Wwf, Wwf, Hhd^Fmf, Xuc, Rp, Wwf, Wwf, Rp, Xuc, Xuc, Xuc, Ur, Rp, Wwf, Xu, Xu, Xu, Xu
Xu, Xu, Xu, Ur, Wwf, Wwf, Rp, Cer, Uu, Rp, Ur, Sm, Uu, Wwf, Qxu, Qxu, Xuc, Wwf, Rp, Rp, Rp, Hhd, Gll^Feth, Rp, Wwf, Rp, Hhd^Fmf, Ias^Vhcr, Wwf, Rp, Ds, Rp, Rp, Rp, Rp, Rp, Wwf, Ur, Xu, Xu, Xu
Xu, Xu, Chw, Chw, Cud, Wwf, Wwf, Rp, Rp, Rp, Ur, Hhd^Fmf, Wwf, Wwf, Wwf, Qxu, Wwf, Wwf, Rp, Ur, Rp, Xuc, Xuc, Wwf, Rp, Wwf, Wwf, Wwf, Rp, Wwf, Wwf, Ds, Wwf, Wwf, Wwf, Wwf, Cud, Chw, Chw, Xu, Xu
Xu, Xu, Chw, 3 Kud, Cud, Xu, Xu, Wwf, Rp, Ias^Vhcr, Rp, Wwf, Cdr, Ds, Rp, Wwf, Hhd^Fdf, Rp, Uu^Tf, Ur, Ur, Rp, Xuc, Rp, Re^Tf, Rp, Wwf, Rp, Ker, Hhd^Fmf, Rp, Wwf, Rp, Rp, Xu, Xu, Cud, 2 Kud, Chw, Xu, Xu
Xu, Xu, Wwg, Cud, Urb^Vud, Xu, Xu, Wwf, Wwf, Rp, Wwf, Wwf, Qxu, Kdr, Rp, Wwf, Rp, Rp, Xuc, Chs, Ur, Rp, Hhd^Fdf, Re, Rp, Rp, Wwf, Xuc, Xuc, Cer, Hhd^Fmf, Wwf, Rp, Ias^Vhcr, Xu, Xu, Urb^Vud, Cud, Wwg, Xu, Xu
Xu, Xu, Wwg, Urb^Ebn, Xu, Xu, Xu, Xu, Xu, Wwf, Xu, Qxu, Qxu, Qxu, Ss, Wwf, Rp, Xuc, Qxu, Ss, Uu, Rp, Rp, Rp, Rp, Chr, Wwf, Xuc, Qxu, Qxu, Qxu, Wwf, Wwg, Rp, Xu, Xu, Xu, Urb^Ebn, Wwg, Xu, Xu
Xu, Xu, Xu, Wwg, Xu, Xu, Xu, Xu, Xu, Xu, Xu, Qxu, Qxu, Qxu, Ss, Rp^Vhcr, Xuc, Xuc, Qxu, Qxu, Qxu, Uu, Ur^Vhc, Hhd^Fdf, Xu, Rp, Xuc, Xuc, Qxu, Qxu, Qxu, Wwg, Wog, Wwg, Xu, Xu, Xu, Wwg, Xu, Xu, Xu
Xu, Xu, Xu, Xu, Xu, Xu, Xu, Xu, Xu, Xu, Xu, Xu, Xu, Xu, Xu, Xu, Xu, Xuc, Xu, Qxu, Xu, Xu, Xu, Xu, Xu, Xu, Xu, Xuc, Xu, Qxu, Xu, Wwg, Xu, Xu, Xu, Xu, Xu, Xu, Xu, Xu, Xu
Xu, Xu, Xu, Xu, Xu, Xu, Xu, Xu, Xu, Xu, Xu, Xu, Xu, Xu, Xu, Xu, Xu, Xu, Xu, Xu, Xu, Xu, Xu, Xu, Xu, Xu, Xu, Xu, Xu, Xu, Xu, Xu, Xu, Xu, Xu, Xu, Xu, Xu, Xu, Xu, Xu
