Xv, Xv, Xv, Xv, Xv, Xv, Xv, Xv, Xv, Xv, Xv, Xv, Xv, Xv, Xv, Xv, Xv, Xv, Xv, Xv, Xv, Xv, Xv, Xv, Xv, Xv, Xv, Xv, Xv, Xv, Xv, Xv, Xv, Xv, Xv
Xv, Xv, Xv, Xv, Xv, Xv, Xv, Xv, Xv, Xv, Xv, Xv, Xv, Xv, Xv, Xv, Qxua^Xo, Qxua^Xo, Qxua^Xo, Xv, Xv, Xv, Xv, Xv, Xv, Xv, Xv, Xv, Xv, Xv, Xv, Xv, Xv, Xv, Xv
Xv, Xv, Xv, Xv, Xv, Xv, Xv, Xv, Xv, Xv, Xv, Xv, Xv, Xv, Qxua^Xo, Qxua^Xo, Wwg, Wog, Uu^Vu, Qxua^Xo, Qxua^Xo, Xv, Xv, Xv, Xv, Xv, Xv, Xv, Xv, Xv, Xv, Xv, Xv, Xv, Xv
Xv, Xv, Xv, Xv, Xv, Xv, Xv, Xv, Xv, Xv, Xv, Xv, Qxua^Xo, Qxua^Xo, Wwf, Wwg, Cfr, Uu, Cfr, Qxu, Qxu, Qxua^Xo, Qxua^Xo, Xv, Xv, Xv, Xv, Xv, Xv, Xv, Xv, Xv, Xv, Xv, Xv
Xv, Xv, Xv, Xv, Xv, Xv, Xv, Xv, Xv, Xv, Qxua^Xo, Qxua^Xo, Hhd, Wwf, Cfr, 3 Kfr, Cfr, Cfr, Cfr, 1 Kfr, Cfr, Xoa, Xoa, Qxua^Xo, Qxua^Xo, Xv, Xv, Xv, Xv, Xv, Xv, Xv, Xv, Xv, Xv
Xv, Xv, Xv, Xv, Xv, Xv, Xv, Xv, Qxua^Xo, Qxua^Xo, Md, Md, Rb, Wwf, Wwf, Cfr, Ias^Edb, Rb^Edb, Gll^Edb, Cfr, Hhd, Xoa, Xoa, Wog, Wog, Qxua^Xo, Qxua^Xo, Xv, Xv, Xv, Xv, Xv, Xv, Xv, Xv
Xv, Xv, Xv, Xv, Xv, Xv, Qxua^Xo, Qxua^Xo, Sm, Hhd, Hhd, Gll^Fmw, Gll^Fdw, Rb, Wwf, Ias, Gll^Vht, Rb^Edb, Gll^Ebn, Gll^Edb, Gll^Fmw, Gll^Fdw, Wwf, Wwg, Wwf, Wwf, Ha, Qxua^Xo, Qxua^Xo, Xv, Xv, Xv, Xv, Xv, Xv
Xv, Xv, Xv, Xv, Qxua^Xo, Qxua^Xo, Uu^Vu, Gll, Gll^Fmw, Sm, Ur, Ur, Ur, Rb, Wwf, Hhd, Gll^Fmw, Rb, Ias, Ias, Ias, Wwf, Aa^Vea, Aa^Esa, Rra^Esa, Aa^Fda, Rra^Esa, Ms, Rra^Esa, Qxua^Xo, Qxua^Xo, Xv, Xv, Xv, Xv
Xv, Xv, Qxua^Xo, Qxua^Xo, Rb, Uu^Tf, Uu, Gll, Hhd, Gll^Fdw, Ur, Uu, Uh, Rb, Rb, Wwf, Wwf, Rb, Gll^Edb, Uu^Tf, Uu, Wwf, Rra^Esa, Rra^Esa, Aa^Esa, Rra^Esa, Ha, Rra^Esa, Aa^Esa, Aa^Fda, Rb, Qxua^Xo, Qxua^Xo, Xv, Xv
Xv, Qxua^Xo, Rb, Rb, Ias^Edt, Rb, Rb, Ur, Ur, Hhd, Ur, Uu^Tf, Uu^Vu, Ur, Ur, Rb, Wwf, Rb, Hhd, Ias, Ias, Wwf, Wwf, Wwf, Wwf, Ha, Rra^Esa, Aa^Vea, Rb, Rb, Ias^Edt, Rb, Rb, Qxua^Xo, Xv
Xv, Qxua^Xo, Rb, Ias^Edt, Rp^Edt, Ias^Edt, Rb, Sm, Gll^Fdw, Ur, Qlf, Qlf, Gll^Fmw, Gll^Fdw, Hhd, Rb, Wwf, Rb, Gll^Fmw, Gll^Fdw, Re^Gvs, Re^Gvs, Re^Gvs, Uu^Edt, Ias^Edt, Wwf, Rra^Esa, Aa^Fda, Rb, Ias^Edt, Rp^Edt, Ias^Edt, Rb, Qxua^Xo, Xv
Xv, Qxua^Xo, Rb, Ias^Edt, Ias^Edt, Ias^Edt, Rb, Sm, Hhd, Gll^Fmw, Sm, Gll, Gll, Hhd, Rb, Rb, Wwf, Rb, Ur^Vht, Hhd^Ecf, Ias, Re^Gvs, Hhd, Uu^Tf, Ias^Edt, Wwf, Aa^Esa, Aa^Esa, Rb, Ias^Edt, Ias^Edt, Ias^Edt, Rb, Qxua^Xo, Xv
Xv, Qxua^Xo, Dd^Ftd, Rb, Rb, Rb, Dd^Es, Rb, Rb, Hhd, Sm, Gll^Fdw, Uu^Tf, Rb, Wwf, Wwf, Gll^Fmf, Wwf^Bw|, Wwf, Ias, Wwf, Ias, Gll^Fdw, Gll^Fmw, Wwf, Wwf, Rb, Rb, Gs^Fds, Rb, Rb, Rb, Ss, Qxua^Xo, Xv
Xv, Qxua^Xo, Rd^Em, Dd^Es, Dd^Vda, Dd^Ftd, Rd, Dd^Edpp, Wwf, Rb, Rb, Uu, Rb, Rb, Wwf, Wog, Wwf, Rb, Hhd^Es, Wwf, Wog, Wwf, Wwf, Wwf, Rb, Rb, Ss, Ss, Cer, Gs^Fms, Ds, Ss, Hh, Qxua^Xo, Xv
Xv, Qxua^Xo, Mdd, Rd, Hd, Rd, Wwf, Wwf, Hh, Wwf, Wwf, Rb, Wwf^Bw\, Wwf, Hhd^Vhr, Wwf, Ur, Rb, Ur^Es, Wwf, Wwf, Gll^Fmf, Wwf^Bw/, Rb, Gs^Fds, Gs^Fms, Rp, Rp, Hh, Ds, Gs^Fds, Gs^Fms, Mm, Qxua^Xo, Xv
Xv, Qxua^Xo, Hd, Rd^Es, Rd^Es, Hd, Wwf, Hh, Gs^Fds, Ss, Ss, Wwf, Gll^Fmf, Rb, Rb, Ur^Es, Rb, Rb, Rb, Ur, Rb, Rb, Wwf, Ds, Ds, Rp, Ss, Hh, Wwf, Wwf, Wwf, Hh, Wwg, Qxua^Xo, Xv
Xv, Qxua^Xo, Wwf, Dd^Edpp, Rd^Es, Dd^Ftd, Wwf, Ds, Ds, Gs^Fms, Rp, Wwf, Wog, Wwf, Ur, Rb, Ias^Edt, Ias^Edt, Ias^Edt, Rb, Ur^Es, Hhd^Es, Wwf, Cer, Gs^Fds, Rp, Ss, Wwf, Rd, Dd^Vda, Dd^Edpp, Wwg, Wog, Qxua^Xo, Xv
Xv, Qxua^Xo, Wog, Wwf, Dd^Edpp, Rd, Rd, Wwf, Ss, Rp, Gs^Fds, Wwf, Wwf, Wwf, Ur^Es, Rb, Ias^Edt, Rp^Edt, Ias^Edt, Rb, Ur, Wwf, Wog, Wwf, Rp, Rp, Ds, Wwf, Wwf, Rd, Rd^Es, Wwf, Wwf, Qxua^Xo, Xv
Xv, Qxua^Xo, Wwg, Wwg, Wwf, Dd^Vda, Wwf, Wwf, Ss, Rp, Ds, Cer, Wwf, Hhd^Es, Rb, Rb, Rb, Ias^Edt, Rb, Rb, Rb, Wwf, Gll^Fmf, Wwf, Ss, Gs^Fms, Gs^Fds, Ds, Wwf, Dd^Ftd, Rd^Es, Dd^Edpp, Hd, Qxua^Xo, Xv
Xv, Qxua^Xo, Mm, Hh, Gs^Fds, Wwf, Hh, Hh, Rp, Rp, Gs^Fds, Ds, Wwf^Bw/, Rb, Wwf, Ur, Ur^Es, Rb, Ur, Ur^Es, Hhd^Vhr, Rb, Wwf^Bw\, Wwf, Wwf, Ss, Hh, Hh, Wwf, Hd, Hd, Rd^Es, Mdd, Qxua^Xo, Xv
Xv, Qxua^Xo, Hh, Gs^Fms, Ds, Ds, Cer, Rp, Ss, Gs^Fms, Rb, Rb, Wwf, Gll^Fmf, Wog, Wwf, Hhd^Es, Rb, Wwf, Wwf, Wwf, Wwf, Rb, Rb, Rb, Wwf, Wwf, Wwf, Rd, Rd, Dd^Vda, Rd, Rd^Em, Qxua^Xo, Xv
Xv, Qxua^Xo, Ss, Ss, Rb, Gs^Fms, Gs^Fds, Ss, Rb, Rb, Wwf, Wwf, Gll^Fdw, Wwf, Wwf, Wwf, Wwf, Rb, Gll^Fmf, Wog, Wwf, Rb, Uu^Tf, Uu, Sm, Rb, Rb, Dd^Edpp, Dd^Es, Dd^Ftd, Rb, Dd^Es, Dd^Ftd, Qxua^Xo, Xv
Xv, Qxua^Xo, Rb, Rb, Ias^Edt, Rb, Rb, Rb, Aa^Esa, Wwf, Ias^Edt, Gll^Fmw, Hhd, Ias, Ias, Ias, Ur^Vht, Wwf^Bw|, Wwf, Wwf, Rb, Rb, Gll, Gll^Fdw, Sm, Hhd, Hhd, Rb, Rb, Rb, Ias^Edt, Rb, Rb, Qxua^Xo, Xv
Xv, Qxua^Xo, Rb, Ias^Edt, Rp^Edt, Ias^Edt, Rb, Aa^Esa, Rra^Esa, Wwf, Ias^Edt, Uu^Tf, Re^Gvs, Re^Gvs, Re^Gvs, Hhd^Ecf, Gll^Fmw, Rb, Wwf, Rb, Hhd, Hhd, Gll^Fmw, Gll, Qlf, Gll^Fmw, Gll^Fdw, Sm, Rb, Ias^Edt, Rp^Edt, Ias^Edt, Rb, Qxua^Xo, Xv
Xv, Qxua^Xo, Rb, Ias^Edt, Ias^Edt, Ias^Edt, Rb, Aa^Fda, Rra^Esa, Wwf, Wwf, Uu^Edt, Wwf, Re^Gvs, Ias, Gll^Fdw, Hhd, Rb, Wwf, Rb, Ur, Gll^Fdw, Uu^Vu, Qlf, Ur, Ur, Ur, Sm, Rb, Ias^Edt, Ias^Edt, Ias^Edt, Rb, Qxua^Xo, Xv
Xv, Qxua^Xo, Qxua^Xo, Rb, Rb, Rb, Aa^Esa, Aa^Vea, Ha, Ha, Aa^Esa, Wwf, Rra^Esa, Wwf, Uu, Ias, Gll^Edb, Rb, Wwf, Rb, Rb, Ur, Uh, Uu^Tf, Ur, Hhd, Hhd, Ur, Uu, Rb, Rb, Rb, Qxua^Xo, Qxua^Xo, Xv
Xv, Xv, Xv, Qxua^Xo, Qxua^Xo, Aa^Fda, Rra^Esa, Rra^Esa, Rra^Esa, Rra^Esa, Rra^Esa, Rra^Esa, Aa^Vea, Wwf, Ias, Uu^Tf, Ias, Rb, Gll^Fmw, Wwf, Wwf, Rb, Ur, Uu, Ur, Gll^Fdw, Gll^Fmw, Gll, Uu^Vu, Uu^Tf, Qxua^Xo, Qxua^Xo, Xv, Xv, Xv
Xv, Xv, Xv, Xv, Xv, Qxua^Xo, Qxua^Xo, Ms, Ha, Aa^Fda, Wwf, Aa^Esa, Wwf, Wwf, Gll^Fmw, Ias, Gll^Ebn, Rb, Gll^Vht, Hhd, Wwf, Rb, Gll^Fdw, Ur, Hhd, Sm, Sm, Gll, Qxua^Xo, Qxua^Xo, Xv, Xv, Xv, Xv, Xv
Xv, Xv, Xv, Xv, Xv, Xv, Xv, Qxua^Xo, Qxua^Xo, Wwf, Wog, Wwg, Xoa, Gll^Fdw, Hhd, Gll^Edb, Gll^Edb, Rb^Edb, Ias^Edb, Ias, Wwf, Rb, Rb, Gll^Fmw, Md, Hhd, Qxua^Xo, Qxua^Xo, Xv, Xv, Xv, Xv, Xv, Xv, Xv
Xv, Xv, Xv, Xv, Xv, Xv, Xv, Xv, Xv, Qxua^Xo, Qxua^Xo, Wog, Xoa, Xoa, Cfr, Cfr, Cfr, Rb^Edb, Cfr, Cfr, Cfr, Wwf, Hhd, Md, Qxua^Xo, Qxua^Xo, Xv, Xv, Xv, Xv, Xv, Xv, Xv, Xv, Xv
Xv, Xv, Xv, Xv, Xv, Xv, Xv, Xv, Xv, Xv, Xv, Qxua^Xo, Qxua^Xo, Xoa, Qxu, 2 Kfr, Cfr, Cfr, Cfr, 4 Kfr, Wwf, Wwf, Qxua^Xo, Qxua^Xo, Xv, Xv, Xv, Xv, Xv, Xv, Xv, Xv, Xv, Xv, Xv
Xv, Xv, Xv, Xv, Xv, Xv, Xv, Xv, Xv, Xv, Xv, Xv, Xv, Qxua^Xo, Qxua^Xo, Qxu, Uu^Vu, Uu, Wwg, Wwg, Qxua^Xo, Qxua^Xo, Xv, Xv, Xv, Xv, Xv, Xv, Xv, Xv, Xv, Xv, Xv, Xv, Xv
Xv, Xv, Xv, Xv, Xv, Xv, Xv, Xv, Xv, Xv, Xv, Xv, Xv, Xv, Xv, Qxua^Xo, Qxua^Xo, Wog, Qxua^Xo, Qxua^Xo, Xv, Xv, Xv, Xv, Xv, Xv, Xv, Xv, Xv, Xv, Xv, Xv, Xv, Xv, Xv
Xv, Xv, Xv, Xv, Xv, Xv, Xv, Xv, Xv, Xv, Xv, Xv, Xv, Xv, Xv, Xv, Xv, Qxua^Xo, Xv, Xv, Xv, Xv, Xv, Xv, Xv, Xv, Xv, Xv, Xv, Xv, Xv, Xv, Xv, Xv, Xv
Xv, Xv, Xv, Xv, Xv, Xv, Xv, Xv, Xv, Xv, Xv, Xv, Xv, Xv, Xv, Xv, Xv, Xv, Xv, Xv, Xv, Xv, Xv, Xv, Xv, Xv, Xv, Xv, Xv, Xv, Xv, Xv, Xv, Xv, Xv
