Xv, Xv, Xv, Xv, Xv, Xv, Xv, Xv, Xv, Xv, Xv, Xv, Xv, Xv, Xv, Xv, Xv, Xv, Xv, Xv, Xv, Xv, Xv, Xv, Xv, Xv, Xv, Xv, Xv, Xv, Xv, Xv, Xv, Xv, Xv
Xv, Xv, Xv, Xv, Xv, Xv, Xv, Xv, Xv, Xv, Xv, Xv, Xv, Xv, Xv, Xv, Qxua^Xo, Qxua^Xo, Qxua^Xo, Xv, Xv, Xv, Xv, Xv, Xv, Xv, Xv, Xv, Xv, Xv, Xv, Xv, Xv, Xv, Xv
Xv, Xv, Xv, Xv, Xv, Xv, Xv, Xv, Xv, Xv, Xv, Xv, Xv, Xv, Qxua^Xo, Qxua^Xo, Wwg, Wog, Uu^Vu, Qxua^Xo, Qxua^Xo, Xv, Xv, Xv, Xv, Xv, Xv, Xv, Xv, Xv, Xv, Xv, Xv, Xv, Xv
Xv, Xv, Xv, Xv, Xv, Xv, Xv, Xv, Xv, Xv, Xv, Xv, Qxua^Xo, Qxua^Xo, Wwf, Wwg, Cfr, Uu, Cfr, Qxu, Qxu, Qxua^Xo, Qxua^Xo, Xv, Xv, Xv, Xv, Xv, Xv, Xv, Xv, Xv, Xv, Xv, Xv
Xv, Xv, Xv, Xv, Xv, Xv, Xv, Xv, Xv, Xv, Qxua^Xo, Qxua^Xo, Hhd, Wwf, Cfr, 3 Kfr, Cfr, Cfr, Cfr, 1 Kfr, Cfr, Xoa, Xoa, Qxua^Xo, Qxua^Xo, Xv, Xv, Xv, Xv, Xv, Xv, Xv, Xv, Xv, Xv
Xv, Xv, Xv, Xv, Xv, Xv, Xv, Xv, Qxua^Xo, Qxua^Xo, Md, Md, Rb, Wwf, Wwf, Cfr, Ias^Edb, Rrc^Edb, Gll^Edb, Cfr, Hhd, Xoa, Xoa, Wog, Wog, Qxua^Xo, Qxua^Xo, Xv, Xv, Xv, Xv, Xv, Xv, Xv, Xv
Xv, Xv, Xv, Xv, Xv, Xv, Qxua^Xo, Qxua^Xo, Sm, Hhd, Hhd, Gll^Fmw, Gll^Fdw, Rb, Wwf, Ias, Gll^Vht, Rrc^Edb, Gll^Ebn, Gll^Edb, Gll^Fmw, Gll^Fdw, Wwf, Wwg, Wwf, Wwf, Ha, Qxua^Xo, Qxua^Xo, Xv, Xv, Xv, Xv, Xv, Xv
Xv, Xv, Xv, Xv, Qxua^Xo, Qxua^Xo, Uu^Vu, Gll, Gll^Fmw, Sm, Ur, Ur, Ur, Rb, Wwf, Hhd, Gll^Fmw, Rrc, Ias, Ias, Ias, Wwf, Aa^Vea, Aa^Esa, Rra^Esa, Aa^Fda, Rra^Esa, Ms, Rra^Esa, Qxua^Xo, Qxua^Xo, Xv, Xv, Xv, Xv
Xv, Xv, Qxua^Xo, Qxua^Xo, Rrc, Uu^Tf, Uu, Gll, Hhd, Gll^Fdw, Ur, Uu, Uh, Rb, Rb, Wwf, Wwf, Rrc, Gll^Edb, Uu^Tf, Uu, Wwf, Rra^Esa, Rra^Esa, Aa^Esa, Rra^Esa, Ha, Rra^Esa, Aa^Esa, Aa^Fda, Rrc, Qxua^Xo, Qxua^Xo, Xv, Xv
Xv, Qxua^Xo, Rrc, Rrc, Ias^Edt, Rrc, Rrc, Ur, Ur, Hhd, Ur, Uu^Tf, Uu^Vu, Ur, Ur, Rb, Wwf, Rrc, Hhd, Ias, Ias, Wwf, Wwf, Wwf, Wwf, Ha, Rra^Esa, Aa^Vea, Rrc, Rrc, Ias^Edt, Rrc, Rrc, Qxua^Xo, Xv
Xv, Qxua^Xo, Rrc, Ias^Edt, Rp^Vov, Ias^Edt, Rrc, Sm, Gll^Fdw, Ur, Qlf, Qlf, Gll^Fmw, Gll^Fdw, Hhd, Rb, Wwf, Rrc, Gll^Fmw, Gll^Fdw, Re^Gvs, Re^Gvs, Re^Gvs, Uu^Edt, Ias^Edt, Wwf, Rra^Esa, Aa^Fda, Rrc, Ias^Edt, Rp^Vov, Ias^Edt, Rrc, Qxua^Xo, Xv
Xv, Qxua^Xo, Rrc, Ias^Edt, Ias^Edt, Ias^Edt, Rrc, Sm, Hhd, Gll^Fmw, Sm, Gll, Gll, Hhd, Rb, Rb, Wwf, Rrc, Ur^Vht, Hhd^Ecf, Ias, Re^Gvs, Hhd, Uu^Tf, Ias^Edt, Wwf, Aa^Esa, Aa^Esa, Rrc, Ias^Edt, Ias^Edt, Ias^Edt, Rrc, Qxua^Xo, Xv
Xv, Qxua^Xo, Dd^Ftd, Rrc, Rrc, Rrc, Dd^Es, Rrc, Rrc, Hhd, Sm, Gll^Fdw, Uu^Tf, Rb, Wwf, Wwf, Gll^Fmf, Wwf^Bw|, Wwf, Ias, Wwf, Ias, Gll^Fdw, Gll^Fmw, Wwf, Wwf, Rrc, Rrc, Gs^Fds, Rrc, Rrc, Rrc, Ss, Qxua^Xo, Xv
Xv, Qxua^Xo, Rd^Em, Dd^Es, Dd^Vda, Dd^Ftd, Rd, Dd^Edpp, Wwf, Rrc, Rrc, Uu, Rb, Rb, Wwf, Wog, Wwf, Rrc, Hhd^Es, Wwf, Wog, Wwf, Wwf, Wwf, Rrc, Rrc, Ss, Ss, Cer, Gs^Fms, Ds, Ss, Hh, Qxua^Xo, Xv
Xv, Qxua^Xo, Mdd, Rd, Hd, Rd, Wwf, Wwf, Hh, Wwf, Wwf, Rrc, Wwf^Bw\, Wwf, Hhd^Vhr, Wwf, Ur, Rrc, Ur^Es, Wwf, Wwf, Gll^Fmf, Wwf^Bw/, Rrc, Gs^Fds, Gs^Fms, Rp, Rp, Hh, Ds, Gs^Fds, Gs^Fms, Mm, Qxua^Xo, Xv
Xv, Qxua^Xo, Hd, Rd^Es, Rd^Es, Hd, Wwf, Hh, Gs^Fds, Ss, Ss, Wwf, Gll^Fmf, Rrc, Rrc, Ur^Es, Rrc, Rrc, Rrc, Ur, Rrc, Rrc, Wwf, Ds, Ds, Rp, Ss, Hh, Wwf, Wwf, Wwf, Hh, Wwg, Qxua^Xo, Xv
Xv, Qxua^Xo, Wwf, Dd^Edpp, Rd^Es, Dd^Ftd, Wwf, Ds, Ds, Gs^Fms, Rp, Wwf, Wog, Wwf, Ur, Rrc, Ias^Edt, Ias^Edt, Ias^Edt, Rrc, Ur^Es, Hhd^Es, Wwf, Cer, Gs^Fds, Rp, Ss, Wwf, Rd, Dd^Vda, Dd^Edpp, Wwg, Wog, Qxua^Xo, Xv
Xv, Qxua^Xo, Wog, Wwf, Dd^Edpp, Rd, Rd, Wwf, Ss, Rp, Gs^Fds, Wwf, Wwf, Wwf, Ur^Es, Rrc, Ias^Edt, Rp^Vov, Ias^Edt, Rrc, Ur, Wwf, Wog, Wwf, Rp, Rp, Ds, Wwf, Wwf, Rd, Rd^Es, Wwf, Wwf, Qxua^Xo, Xv
Xv, Qxua^Xo, Wwg, Wwg, Wwf, Dd^Vda, Wwf, Wwf, Ss, Rp, Ds, Cer, Wwf, Hhd^Es, Rrc, Rrc, Rrc, Ias^Edt, Rrc, Rrc, Rrc, Wwf, Gll^Fmf, Wwf, Ss, Gs^Fms, Gs^Fds, Ds, Wwf, Dd^Ftd, Rd^Es, Dd^Edpp, Hd, Qxua^Xo, Xv
Xv, Qxua^Xo, Mm, Hh, Gs^Fds, Wwf, Hh, Hh, Rp, Rp, Gs^Fds, Ds, Wwf^Bw/, Rrc, Wwf, Ur, Ur^Es, Rrc, Ur, Ur^Es, Hhd^Vhr, Rrc, Wwf^Bw\, Wwf, Wwf, Ss, Hh, Hh, Wwf, Hd, Hd, Rd^Es, Mdd, Qxua^Xo, Xv
Xv, Qxua^Xo, Hh, Gs^Fms, Ds, Ds, Cer, Rp, Ss, Gs^Fms, Rrc, Rrc, Wwf, Gll^Fmf, Wog, Wwf, Hhd^Es, Rrc, Wwf, Wwf, Wwf, Wwf, Rb, Rrc, Rrc, Wwf, Wwf, Wwf, Rd, Rd, Dd^Vda, Rd, Rd^Em, Qxua^Xo, Xv
Xv, Qxua^Xo, Ss, Ss, Rrc, Gs^Fms, Gs^Fds, Ss, Rrc, Rrc, Wwf, Wwf, Gll^Fdw, Wwf, Wwf, Wwf, Wwf, Rrc, Gll^Fmf, Wog, Wwf, Rb, Uu^Tf, Uu, Sm, Rrc, Rrc, Dd^Edpp, Dd^Es, Dd^Ftd, Rrc, Dd^Es, Dd^Ftd, Qxua^Xo, Xv
Xv, Qxua^Xo, Rrc, Rrc, Ias^Edt, Rrc, Rrc, Rrc, Aa^Esa, Wwf, Ias^Edt, Gll^Fmw, Hhd, Ias, Ias, Ias, Ur^Vht, Wwf^Bw|, Wwf, Wwf, Rb, Rb, Gll, Gll^Fdw, Sm, Hhd, Hhd, Rrc, Rrc, Rrc, Ias^Edt, Rrc, Rrc, Qxua^Xo, Xv
Xv, Qxua^Xo, Rrc, Ias^Edt, Rp^Vov, Ias^Edt, Rrc, Aa^Esa, Rra^Esa, Wwf, Ias^Edt, Uu^Tf, Re^Gvs, Re^Gvs, Re^Gvs, Hhd^Ecf, Gll^Fmw, Rrc, Wwf, Rb, Hhd, Hhd, Gll^Fmw, Gll, Qlf, Gll^Fmw, Gll^Fdw, Sm, Rrc, Ias^Edt, Rp^Vov, Ias^Edt, Rrc, Qxua^Xo, Xv
Xv, Qxua^Xo, Rrc, Ias^Edt, Ias^Edt, Ias^Edt, Rrc, Aa^Fda, Rra^Esa, Wwf, Wwf, Uu^Edt, Wwf, Re^Gvs, Ias, Gll^Fdw, Hhd, Rrc, Wwf, Rb, Ur, Gll^Fdw, Uu^Vu, Qlf, Ur, Ur, Ur, Sm, Rrc, Ias^Edt, Ias^Edt, Ias^Edt, Rrc, Qxua^Xo, Xv
Xv, Qxua^Xo, Qxua^Xo, Rrc, Rrc, Rrc, Aa^Esa, Aa^Vea, Ha, Ha, Aa^Esa, Wwf, Rra^Esa, Wwf, Uu, Ias, Gll^Edb, Rrc, Wwf, Rb, Rb, Ur, Uh, Uu^Tf, Ur, Hhd, Hhd, Ur, Uu, Rrc, Rrc, Rrc, Qxua^Xo, Qxua^Xo, Xv
Xv, Xv, Xv, Qxua^Xo, Qxua^Xo, Aa^Fda, Rra^Esa, Rra^Esa, Rra^Esa, Rra^Esa, Rra^Esa, Rra^Esa, Aa^Vea, Wwf, Ias, Uu^Tf, Ias, Rrc, Gll^Fmw, Wwf, Wwf, Rb, Ur, Uu, Ur, Gll^Fdw, Gll^Fmw, Gll, Uu^Vu, Uu^Tf, Qxua^Xo, Qxua^Xo, Xv, Xv, Xv
Xv, Xv, Xv, Xv, Xv, Qxua^Xo, Qxua^Xo, Ms, Ha, Aa^Fda, Wwf, Aa^Esa, Wwf, Wwf, Gll^Fmw, Ias, Gll^Ebn, Rrc, Gll^Vht, Hhd, Wwf, Rb, Gll^Fdw, Ur, Hhd, Sm, Sm, Gll, Qxua^Xo, Qxua^Xo, Xv, Xv, Xv, Xv, Xv
Xv, Xv, Xv, Xv, Xv, Xv, Xv, Qxua^Xo, Qxua^Xo, Wwf, Wog, Wwg, Xoa, Gll^Fdw, Hhd, Gll^Edb, Gll^Edb, Rrc^Edb, Ias^Edb, Ias, Wwf, Rb, Rb, Gll^Fmw, Md, Hhd, Qxua^Xo, Qxua^Xo, Xv, Xv, Xv, Xv, Xv, Xv, Xv
Xv, Xv, Xv, Xv, Xv, Xv, Xv, Xv, Xv, Qxua^Xo, Qxua^Xo, Wog, Xoa, Xoa, Cfr, Cfr, Cfr, Rrc^Edb, Cfr, Cfr, Cfr, Wwf, Hhd, Md, Qxua^Xo, Qxua^Xo, Xv, Xv, Xv, Xv, Xv, Xv, Xv, Xv, Xv
Xv, Xv, Xv, Xv, Xv, Xv, Xv, Xv, Xv, Xv, Xv, Qxua^Xo, Qxua^Xo, Xoa, Qxu, 2 Kfr, Cfr, Cfr, Cfr, 4 Kfr, Wwf, Wwf, Qxua^Xo, Qxua^Xo, Xv, Xv, Xv, Xv, Xv, Xv, Xv, Xv, Xv, Xv, Xv
Xv, Xv, Xv, Xv, Xv, Xv, Xv, Xv, Xv, Xv, Xv, Xv, Xv, Qxua^Xo, Qxua^Xo, Qxu, Uu^Vu, Uu, Wwg, Wwg, Qxua^Xo, Qxua^Xo, Xv, Xv, Xv, Xv, Xv, Xv, Xv, Xv, Xv, Xv, Xv, Xv, Xv
Xv, Xv, Xv, Xv, Xv, Xv, Xv, Xv, Xv, Xv, Xv, Xv, Xv, Xv, Xv, Qxua^Xo, Qxua^Xo, Wog, Qxua^Xo, Qxua^Xo, Xv, Xv, Xv, Xv, Xv, Xv, Xv, Xv, Xv, Xv, Xv, Xv, Xv, Xv, Xv
Xv, Xv, Xv, Xv, Xv, Xv, Xv, Xv, Xv, Xv, Xv, Xv, Xv, Xv, Xv, Xv, Xv, Qxua^Xo, Xv, Xv, Xv, Xv, Xv, Xv, Xv, Xv, Xv, Xv, Xv, Xv, Xv, Xv, Xv, Xv, Xv
Xv, Xv, Xv, Xv, Xv, Xv, Xv, Xv, Xv, Xv, Xv, Xv, Xv, Xv, Xv, Xv, Xv, Xv, Xv, Xv, Xv, Xv, Xv, Xv, Xv, Xv, Xv, Xv, Xv, Xv, Xv, Xv, Xv, Xv, Xv
