border_size=1
usage=map

Mm          , Mm          , Hh          , Mm          , Mm          , Mm          , Gg          , Gg          , Mm          , Uh          , Uu          , Uu          , Uh          , Uh          , Gg          , Gg          , Gg          , Gs^Fmf      , Hh^Fms      , Hh          , Gg          , Gg          , Gg          , Hh          , Hh^Fms      , Gs^Fdf      , Gg          , Gg          , Gg          , Uh          , Uh          , Uu          , Uu          , Uh          , Mm          , Gg          , Gg          , Mm          , Mm          , Mm          , Mm          , Mm          
Hh          , Hh          , Hh^Vhh      , Hh          , Gg          , Gg          , Hh^Fms      , Gg          , Mm          , Uh          , Uu          , Uu          , Uu^Tf       , Gg          , Gs^Fp       , Gg          , Hh          , Gg          , Gg          , Gg          , Gg          , Gg          , Gs^Fp       , Gg          , Gg          , Gg          , Gg          , Gg          , Gg          , Gg          , Uh          , Uu          , Uu          , Uh          , Mm          , Gg          , Hh^Fms      , Gg          , Gg          , Hh          , Hh^Vhh      , Mm          
Gg          , Hh          , Gg          , Ch          , 2 Kh        , Ch          , Gg          , Gg          , Uu^Tf       , Uh          , Uu^Vu       , Uu^Tf       , Gg          , Gg          , Hh^Fp       , Gg          , Gg          , Gg          , Gg          , Gg          , Mm          , Mm          , Mm          , Gg          , Gg          , Hh          , Gg          , Gs^Fms      , Hh^Fds      , Gg          , Uu^Tf       , Uu          , Uu^Vu       , Uu^Tf       , Gg          , Gg          , Gg          , Ch          , 4 Kh        , Ch          , Gg          , Hh          
Ww          , Gg          , Wwf         , Ch          , Ch          , Ch          , Rr          , Gg          , Gg          , Gg          , Gg          , Gg          , Gg          , Gg          , Hh          , Gg          , Gg^Ve       , Hh          , Gg          , Hh^Fp       , Gs^Fp       , Mm          , Gs^Fp       , Hh^Fp       , Gg          , Uu^Tf       , Gg^Ve       , Gg          , Uu^Tf       , Gg          , Gg          , Uh          , Gg          , Gg          , Gg          , Gg          , Rr          , Ch          , Ch          , Ch          , Ww          , Gg          
Ww          , Ww          , Ww          , Ww          , Chw         , Ww          , Ww          , Rr          , Rr          , Gg^Vh       , Rr          , Gg          , Hh^Fmf      , Gg          , Rr          , Rr          , Gg          , Uu^Tf       , Gg          , Gg          , Gg          , Hh          , Gg          , Gg          , Gg          , Hh          , Gg          , Rr          , Rr          , Gg          , Hh^Fmf      , Gg          , Gg          , Gg^Vh       , Rr          , Rr          , Ww          , Ww          , Chw         , Wwf         , Ww          , Ww          
Ww          , Ww          , Ww          , Ww          , Ww          , Ww          , Ww          , Ss          , Ss          , Rr          , Gg          , Rr          , Rr          , Rr          , Gg          , Gg          , Gg          , Gg          , Gg          , Gg          , Gg          , Gg          , Gg          , Gg          , Gg          , Gg          , Gg          , Gg          , Gg          , Rr          , Rr          , Rr          , Rp          , Rr          , Ss          , Ss          , Ww          , Ww          , Ww          , Ww          , Ww          , Ww          
Md          , Ds          , Hd          , Ds          , Ds          , Ww          , Gg          , Ss^Vhs      , Hh^Fms      , Ww^Bw|      , Ww          , Gg          , Hh^Fp       , Gg          , Gg          , Ss          , Mm          , Hh^Fmf      , Gg          , Gg          , Mm          , Gs^Fp       , Hh          , Gg          , Gg          , Hh^Fmf      , Mm          , Ss          , Gg          , Gg          , Hh^Fp       , Ds          , Ww^Bw|      , Ww          , Ss          , Ss^Vhs      , Gg          , Ww          , Ds          , Ds          , Ds          , Ds          
Md^Xm       , Md^Xm       , Gs^Ft       , Md          , Hd          , Ds          , Ds          , Ww          , Gg          , Rp          , Hh^Fms      , Ww          , Ww          , Ww          , Ww          , Gs^Fp       , Hh          , Dd^Do       , Ds          , Gg          , Hh          , Hh^Fms      , Ds          , Gg          , Ds          , Dd^Do       , Hh          , Gs^Fp       , Ww          , Ww          , Ww          , Ww          , Rp          , Hh^Fmf      , Ww          , Gg          , Gs^Ft       , Ds          , Md          , Hd          , Md^Xm       , Md          
Md          , Md^Xm       , Ds          , Uu^Tf       , Gs^Ft       , Ds          , Ww          , Ww          , Gg          , Rp          , Gg          , Gs^Ft       , Gg          , Ww          , Mm          , Ww          , Wwf         , Wwf         , Wwf         , Ds          , Ds          , Gg^Ve       , Hh          , Ds          , Wwf         , Wwf         , Wwf         , Ww          , Mm          , Ww          , Gg          , Gs^Ft       , Rp          , Gg          , Ww          , Ds          , Ds          , Hd          , Uu^Tf       , Gs^Ft       , Md^Xm       , Md^Xm       
Ds          , Dd^Dc       , Hd          , Gg          , Gg          , Ww          , Gg          , Gg          , Gg          , Rp          , Gg          , Hh^Fds      , Chr         , Gg          , Gg^Vh       , Wwf         , Wwf         , Hh^Fms      , Wwf         , Wwf         , Hh^Fms      , Gs^Fp       , Mm          , Wwf         , Wwf         , Hh^Fms      , Wwf         , Wwf         , Gg^Vh       , Gg          , Chr         , Hh^Fds      , Rp          , Gg          , Gg          , Ww          , Ww          , Gs^Ft       , Gg          , Ds          , Dd^Dc       , Md          
Ds          , Ds          , Hd          , Dd^Vda      , Gs^Ft       , Gg          , Hh          , Gg          , Uu^Tf       , Rp          , Gs          , Khr         , Chr         , Gg^Efm      , Gg          , Hh          , Ww          , Wwf         , Wwf         , Chs         , Gg          , Gg          , Gg          , Chs         , Wwf         , Wwf         , Ww          , Hh          , Gg          , Gs          , Chr         , Khr         , Rp          , Gg          , Gg          , Gg          , Gg          , Gg          , Dd^Vda      , Hd          , Ds          , Ds          
Ds          , Ds          , Uu^Tf       , Ss          , Gg          , Gg          , Gs^Fp       , Hh^Fp       , Gs          , Rp          , Re^Gvs      , Chr         , Rd          , Gg^Efm      , Mm          , Gg          , Ww          , Ww          , Rd          , Hh^Fmw      , Rd          , Gg          , Rd          , Hh^Fmw      , Rd          , Ww          , Ww          , Gg          , Mm          , Gs          , Rd          , Chr         , Rp          , Uu^Tf       , Hh^Fms      , Hh          , Gg          , Gs^Ft       , Ss          , Hd          , Ds          , Ds          
Hh          , Hh          , Mm          , Ss          , Ww          , Gg          , Gg          , Mm          , Gg^Efm      , Rp          , Gg^Vl       , Re^Gvs      , Gg          , Rd          , Rd          , Gg^Wm       , Rd          , Ww^Bw/      , Gg^Fet      , Rd          , Gg          , Rd          , Gg          , Rd          , Hh          , Ww^Bw\      , Rd          , Gg^Wm       , Rd          , Rd          , Re^Gvs      , Re^Gvs      , Rp          , Gg^Efm      , Mm          , Gs^Fp       , Gg          , Gg          , Ss          , Uu^Tf       , Hh          , Ds          
Gg^Efm      , Mm          , Hh^Fms      , Gs^Fp       , Ww          , Ww          , Gg          , Ss          , Rr          , Rr          , Hh          , Ss          , Gg          , Hh^Fds      , Gg          , Rd          , Gg          , Wwf         , Ww          , Ww          , Hh          , Uu^Tf       , Hh^Fms      , Ww          , Ww          , Wwf         , Ss          , Rd          , Gg          , Hh^Fds      , Ss          , Gg^Vl       , Rr          , Gg^Efm      , Ss          , Gg          , Gg          , Ww          , Gs^Fp       , Mm          , Mm          , Hh          
Gg^Efm      , Uu^Tf       , Hh          , Gs^Fp       , Gg          , Gg          , Gg          , Gg          , Rr          , Gs^Fms      , Gg          , Gs^Fms      , Gg          , Gg          , Ss          , Hh          , Ww          , Ww          , Wwr         , Ww          , Wwf         , Ww^Vm       , Ww          , Ww          , Wwr         , Ww          , Ww          , Ss          , Gg          , Gg          , Gs^Fms      , Hh          , Gs^Fms      , Rr          , Gg          , Gg          , Gg          , Gg          , Ss          , Hh^Fms      , Uu^Tf       , Gg^Efm      
Gg^Efm      , Gg^Efm      , Gg          , Gg          , Gs^Ft       , Gg          , Gg          , Gg          , Rr          , Gg          , Gg          , Gg          , Gg          , Gg          , Gg          , Hh^Fds      , Ww          , Wo          , Wo          , Ww          , Wwf         , Wwf         , Ww          , Wo          , Wo          , Ww          , Ww          , Ww          , Gg          , Gg          , Gg          , Gg          , Gg          , Rr          , Gg          , Gg          , Gg          , Ss          , Ss          , Gg          , Gg          , Gg^Efm      
Gg^Efm      , Gg          , Gg          , Ss          , Ss          , Gg          , Gg          , Gg          , Rr          , Gg          , Gg          , Gg          , Gg          , Gg          , Ww          , Ww          , Ww          , Wo          , Wo          , Ww          , Wwf         , Wwf         , Ww          , Wo          , Wo          , Ww          , Hh^Fds      , Gg          , Gg          , Gg          , Gg          , Gg          , Gg          , Rr          , Gg          , Gg          , Gg          , Gs^Ft       , Gg          , Gg          , Gg^Efm      , Gg^Efm      
Gg^Efm      , Uu^Tf       , Hh^Fms      , Ss          , Gg          , Gg          , Gg          , Gg          , Rr          , Gs^Fms      , Hh          , Gs^Fms      , Gg          , Gg          , Ss          , Ww          , Ww          , Wwr         , Ww          , Ww          , Ww^Vm       , Wwf         , Ww          , Wwr         , Ww          , Ww          , Hh          , Ss          , Gg          , Gg          , Gs^Fms      , Gg          , Gs^Fms      , Rr          , Gg          , Gg          , Gg          , Gg          , Gs^Fp       , Hh          , Uu^Tf       , Gg^Efm      
Hh          , Mm          , Mm          , Gs^Fp       , Ww          , Gg          , Gg          , Ss          , Gg^Efm      , Rr          , Gg^Vl       , Ss          , Hh^Fds      , Gg          , Rd          , Ss          , Wwf         , Ww          , Ww          , Hh^Fms      , Uu^Tf       , Hh          , Ww          , Ww          , Wwf         , Gg          , Rd          , Gg          , Hh^Fds      , Gg          , Ss          , Hh          , Rr          , Rr          , Ss          , Gg          , Ww          , Ww          , Gs^Fp       , Hh^Fms      , Mm          , Gg^Efm      
Ds          , Hh          , Uu^Tf       , Ss          , Gg          , Gg          , Gs^Fp       , Mm          , Gg^Efm      , Rp          , Re^Gvs      , Re^Gvs      , Rd          , Rd          , Gg^Wm       , Rd          , Ww^Bw\      , Hh          , Rd          , Gg          , Rd          , Gg          , Rd          , Gg^Fet      , Ww^Bw/      , Rd          , Gg^Wm       , Rd          , Rd          , Gg          , Re^Gvs      , Gg^Vl       , Rp          , Gg^Efm      , Mm          , Gg          , Gg          , Ww          , Ss          , Mm          , Hh          , Hh          
Ds          , Ds          , Hd          , Ss          , Gs^Ft       , Gg          , Hh          , Hh^Fms      , Uu^Tf       , Rp          , Chr         , Rd          , Gs          , Mm          , Gg          , Ww          , Ww          , Rd          , Hh^Fmw      , Rd          , Gg          , Rd          , Hh^Fmw      , Rd          , Ww          , Ww          , Gg          , Mm          , Gg^Efm      , Rd          , Chr         , Re^Gvs      , Rp          , Gs          , Hh^Fp       , Gs^Fp       , Gg          , Gg          , Ss          , Uu^Tf       , Ds          , Ds          
Ds          , Ds          , Hd          , Dd^Vda      , Gg          , Gg          , Gg          , Gg          , Gg          , Rp          , Khr         , Chr         , Gs          , Gg          , Hh          , Ww          , Wwf         , Wwf         , Chs         , Gg          , Gg          , Gg          , Chs         , Wwf         , Wwf         , Ww          , Hh          , Gg          , Gg^Efm      , Chr         , Khr         , Gs          , Rp          , Uu^Tf       , Gg          , Hh          , Gg          , Gs^Ft       , Dd^Vda      , Hd          , Ds          , Ds          
Md          , Dd^Dc       , Ds          , Gg          , Gs^Ft       , Ww          , Ww          , Gg          , Gg          , Rp          , Hh^Fds      , Chr         , Gg          , Gg^Vh       , Wwf         , Wwf         , Hh^Fms      , Wwf         , Wwf         , Mm          , Gs^Fp       , Hh^Fms      , Wwf         , Wwf         , Hh^Fms      , Wwf         , Wwf         , Gg^Vh       , Gg          , Chr         , Hh^Fds      , Gg          , Rp          , Gg          , Gg          , Gg          , Ww          , Gg          , Gg          , Hd          , Dd^Dc       , Ds          
Md^Xm       , Md^Xm       , Gs^Ft       , Uu^Tf       , Hd          , Ds          , Ds          , Ww          , Gg          , Rp          , Gs^Ft       , Gg          , Ww          , Mm          , Ww          , Wwf         , Wwf         , Wwf         , Ds          , Hh          , Gg^Ve       , Ds          , Ds          , Wwf         , Wwf         , Wwf         , Ww          , Mm          , Ww          , Gg          , Gs^Ft       , Gg          , Rp          , Gg          , Ww          , Ww          , Ds          , Gs^Ft       , Uu^Tf       , Ds          , Md^Xm       , Md          
Md          , Md^Xm       , Hd          , Md          , Ds          , Gs^Ft       , Gg          , Ww          , Hh^Fmf      , Rp          , Ww          , Ww          , Ww          , Ww          , Gs^Fp       , Hh          , Dd^Do       , Ds          , Gg          , Ds          , Hh^Fms      , Hh          , Gg          , Ds          , Dd^Do       , Hh          , Gs^Fp       , Ww          , Ww          , Ww          , Ww          , Hh^Fms      , Rp          , Gg          , Ww          , Ds          , Gs^Ft       , Hd          , Md          , Gs^Ft       , Md^Xm       , Md^Xm       
Ds          , Ds          , Ds          , Ds          , Ww          , Gg          , Ss^Vhs      , Ss          , Ww          , Ww^Bw|      , Ds          , Hh^Fp       , Gg          , Gg          , Ss          , Mm          , Hh^Fmf      , Gg          , Gg          , Hh          , Gs^Fp       , Mm          , Gg          , Gg          , Hh^Fmf      , Mm          , Ss          , Gg          , Gg          , Hh^Fp       , Gg          , Ww          , Ww^Bw|      , Hh^Fms      , Ss^Vhs      , Gg          , Ww          , Ds          , Ds          , Hd          , Ds          , Md          
Ww          , Ww          , Ww          , Ww          , Ww          , Ww          , Ss          , Ss          , Rr          , Rp          , Rr          , Rr          , Rr          , Gg          , Gg          , Gg          , Gg          , Gg          , Gg          , Gg          , Gg          , Gg          , Gg          , Gg          , Gg          , Gg          , Gg          , Gg          , Rr          , Rr          , Rr          , Gg          , Rr          , Ss          , Ss          , Ww          , Ww          , Ww          , Ww          , Ww          , Ww          , Ww          
Ww          , Ww          , Wwf         , Chw         , Ww          , Ww          , Rr          , Rr          , Gg^Vh       , Gg          , Gg          , Hh^Fmf      , Gg          , Rr          , Rr          , Gg          , Hh          , Gg          , Gg          , Gg          , Hh          , Gg          , Gg          , Gg          , Uu^Tf       , Gg          , Rr          , Rr          , Gg          , Hh^Fmf      , Gg          , Rr          , Gg^Vh       , Rr          , Rr          , Ww          , Ww          , Chw         , Ww          , Ww          , Ww          , Ww          
Gg          , Ww          , Ch          , Ch          , Ch          , Rr          , Gg          , Gg          , Gg          , Gg          , Uh          , Gg          , Gg          , Uu^Tf       , Gg          , Gg^Ve       , Uu^Tf       , Gg          , Hh^Fp       , Gs^Fp       , Mm          , Gs^Fp       , Hh^Fp       , Gg          , Hh          , Gg^Ve       , Gg          , Hh          , Gg          , Gg          , Gg          , Gg          , Gg          , Gg          , Gg          , Rr          , Ch          , Ch          , Ch          , Wwf         , Gg          , Ww          
Hh          , Gg          , Ch          , 5 Kh        , Ch          , Gg          , Gg          , Gg          , Uu^Tf       , Uu^Vu       , Uu          , Uu^Tf       , Gg          , Hh^Fds      , Gs^Fms      , Gg          , Hh          , Gg          , Gg          , Mm          , Mm          , Mm          , Gg          , Gg          , Gg          , Gg          , Gg          , Hh^Fp       , Gg          , Gg          , Uu^Tf       , Uu^Vu       , Uh          , Uu^Tf       , Gg          , Gg          , Ch          , 3 Kh        , Ch          , Gg          , Hh          , Gg          
Mm          , Hh^Vhh      , Hh          , Gg          , Gg          , Hh^Fms      , Gg          , Mm          , Uh          , Uu          , Uu          , Uh          , Gg          , Gg          , Gg          , Gg          , Gg          , Gg          , Gg          , Gs^Fp       , Gg          , Gg          , Gg          , Gg          , Gg          , Hh          , Gg          , Gs^Fp       , Gg          , Uu^Tf       , Uu          , Uu          , Uh          , Mm          , Gg          , Hh^Fms      , Gg          , Gg          , Hh          , Hh^Vhh      , Hh          , Hh          
Mm          , Mm          , Mm          , Mm          , Mm          , Gg          , Gg          , Mm          , Uh          , Uu          , Uu          , Uh          , Uh          , Gg          , Gg          , Gg          , Gs^Fdf      , Hh^Fms      , Hh          , Gg          , Gg          , Gg          , Hh          , Hh^Fms      , Gs^Fmf      , Gg          , Gg          , Gg          , Uh          , Uh          , Uu          , Uu          , Uh          , Mm          , Gg          , Gg          , Mm          , Mm          , Mm          , Hh          , Mm          , Mm          
