Qxu, Qxu, Qxu, Uu, Qxu, Uu, Uu, Rp, Uu, Qxu, Qxu, Xu, Qxu, Qxu, Uu, Rp, Uu, Uu, Qxu, Uu, Qxu, Qxu, Qxu
Qxu, Qxu, Uu^Emf, Uu, Qxu, Uu^Emf, Rp, Rp, Ur, Qxu, Qxu, Xu, Qxu, Qxu, Ur, Rp, Rp, Uu^Emf, Qxu, Uu, Uu^Emf, Qxu, Qxu
Xoi, Qxu, Xoi^Efs, Qxu, Chr, Rp, Uu^Emf, Ur, Uu^Tf, Uh, Wo, Xu, Wo, Uh, Uu^Tf, Ur, Uu^Emf, Rp, Chr, Qxu, Xoi^Efs, Qxu, Xoi
Qxu, Xoi, Qxu, Qxu, Wwf, Wwf^Bw|, Wwf, Uu, Wwf, Ww, Qxu, Xu, Qxu, Ww, Wwf, Uu, Wwf, Wwf^Bw|, Wwf, Qxu, Qxu, Xoi, Qxu
Ur, Qxu, Ur, Wwf, Ias^Edb, Ur^Edb, Ias^Edb, Wwf, Rra^Esa, Rra^Esa, Qxu, Qxu, Qxu, Rra^Esa, Rra^Esa, Wwf, Ias^Es, Ur^Edb, Ias^Edb, Wwf, Ur, Qxu, Ur
Uh, Ur^Emf, Uu^Emf, Wwf, Ias^Es, Ur^Edb, Ur^Es, Wwf, Aa^Esa, Ha^Fda, Aa^Fpa, Qxu, Aa^Fpa, Ha^Fda, Aa^Esa, Wwf, Ur^Es, Ur^Edb, Ias^Es, Wwf, Uu^Emf, Ur^Emf, Uh
Qxu, Uu^Tf, Wwf, Wwf, Wwf, Ias^Es, Wwf, Wwf^Bw\, Rp, Aa^Esa, Gd^Es, Gd^Es, Gd^Es, Aa^Esa, Rp, Wwf^Bw/, Wwf, Ias^Edb, Wwf, Wwf, Wwf, Uu^Tf, Qxu
Qxu, Wwf, Gd^Edb, Gd^Edb, Gll^Gvs, Wwf, Gd, Gd^Es, Gd^Es, Rp, Hhd, Gll^Es, Gll^Fdw, Rp, Gd^Es, Gd^Es, Gd, Wwf, Gll^Gvs, Gd^Edb, Gd^Edb, Wwf, Qxu
Qxu, Wwf, Gll^Emf, Hhd^Emf, Gll, Gll^Fdw, Cfr, Hhd^Emf, Gd, Rp, Gll^Fdw, Md, Hhd, Rp, Gd, Hhd^Emf, Cfr, Gll^Fdw, Gll, Hhd^Emf, Gll^Emf, Wwf, Qxu
Qxu, Wwf, Gll^Es, Gll^Fmw, Gll^Gvs, Cfr, Gll^Feth, Cfr^Ebn, Rp, Rp, Ss, Gll^Efm, Ss, Rp, Rp, Cfr^Ebn, Gll^Feth, Cfr, Gll^Gvs, Gll^Fmw, Gll^Es, Wwf, Qxu
Qxu, Wwf, Wwf, Gd^Gvs, Gd^Vl, Gll, Wwf, Gd, Rp, Ss^Vhs, Gll^Efm, Gll^Efm, Gll^Efm, Ss^Vhs, Rp, Gd, Wwf, Gll, Gd^Vl, Gd^Gvs, Wwf, Wwf, Qxu
Dd^Edp, Hd, Ds^Edp, Wwf, Wwf, Wwf, Rp, Wwf^Bw/, Wwf, Ss, Hhd^Es, Cvr, Hhd^Es, Ss, Wwf, Wwf^Bw\, Rp, Wwf, Wwf, Wwf, Ds^Edp, Hd, Dd^Edpp
Dd^Edp, Dd^Vda, Ds^Edp, Ce^Ebn, Gll, Gll^Fp, Rp, Hhd^Vhh, Wwf, Gs^Es, Gs, Cvr^Ebn, Gs, Gs^Es, Wwf, Hhd^Vhh, Rp, Gll^Fp, Gll, Ce^Ebn, Ds^Edp, Dd^Vda, Dd^Edpp
Gll^Esd, Dd^Ftd, Gll^Esd, Gll^Esd, Rp, Rp^Edt, Gd^Edt, Gd, Wwf, Gs^Fds, Gll^Efm, Gs^Efm, Gll^Efm, Gs^Fds, Wwf, Gd, Gd^Edt, Rp^Edt, Rp, Gll^Esd, Gll^Esd, Dd^Ftd, Gll^Esd
Gll, Gll^Esd, Gll^Vh, Rp, Cf, Gll^Edt, Cf, Gll, Hhd^Edb, Wwf, Gll, Gs^Efm, Gll, Wwf, Hhd^Edb, Gll, Cf, Gll^Edt, Cf, Rp, Gll^Vh, Gll^Esd, Gll
Gll, Gll^Fdf, Hhd, Rp, Cf, 2 Kf, Cf, Gll^Edb, Gll^Edb, Wwf, Gs^Edb, Gs^Fds, Gs^Edb, Wwf, Gll^Edb, Gll^Edb, Cf, 3 Kf, Cf, Rp, Hhd, Gll^Fdf, Gll
Gll, Gll, Gll, Rp, Gs, Gll, Gs, Gll, Gs, Wwf, Gll, Hh, Gs, Wwf, Gs, Gll, Gs, Gll, Gs, Rp, Gll, Gll, Gs
